adolf => adolph
adolph => adolf
agnes => agnès , ines , inês , inés
agnès => inês , agnes , ines , inés
ahmad => aḥmad , aḥmed , ʿahmed , ахмед , àhmad , ahmed , ахмад
ahmed => aḥmad , aḥmed , ahmad , ʿahmed , ахмед , àhmad , ахмад
alaksandar => аляксандр , alaksandr , аляксандар
alaksandr => alaksandar , аляксандр , аляксандар
aleksandar => александар , алеқсандр , александр , aleksandr
aleksander => александер , alexandre , alexander , александр , aleksándr , aleksandr , alexánder , aleksandër
aleksandr => alexandr , александер , alexandre , alexander , oleksandr , олександр , александар , aleksander , алеқсандр , александр , александрович , aleksándr , aleksandrovič , aleksandar , ołeksandr , alexánder , алєксандр
aleksandrovich => aleksandrovitsj
aleksandrovitsj => aleksandrovich
aleksandrovič => александрович , aleksandr , александр
aleksandrovna => alexandrowna
aleksandër => aleksander , alexánder , alexander
alekseevitsj => aleksejevitsj , alekseyevich
aleksei => aleksey , alexei , alexeï , alekseï , alexej , alekseĭ , alekséi , aleksej , aleksiej , alexéi , alekseý
aleksej => aleksey , oleksij , alexei , alexeï , алексеј , alexej , алексей , aleksei , олексій , ołeksij , alekseý , alexéi
aleksejevitsj => alekseyevich , alekseevitsj
aleksey => alexei , alexeï , aleksei , aleksej , alexéi , alekseý
alekseyevich => aleksejevitsj , alekseevitsj
alekseï => alexei , alexeï , alexej , alekseĭ , aleksei , alekséi , aleksiej , alexéi
alekseý => alexei , alexeï , aleksei , aleksej , aleksey , alexéi
alekseĭ => alexei , alexeï , alekseï , alekséi , aleksei , aleksiej , alexéi
aleksiej => alexei , alexeï , alekseï , alekseĭ , aleksei , alexéi
aleksándr => alexandr , александер , alexandre , alexander , aleksander , александр , aleksandr , alexánder
alekséi => alexei , alexeï , alekseï , alexej , alekseĭ , aleksei , alexéi
alex => 亞力克斯 , الکس , àlex , ألكس , آلکس , 亞歴克斯 , 亚历克斯 , 亚力克斯 , άλεξ , 亞歷克斯 , álex
alexander => alexandr , alexandre , aleksander , aleksándr , aleksandr , alexánder , aleksandër
alexandr => aleksándr , aleksandr , alexander
alexandre => aleksándr , aleksandr , aleksander , alexander
alexandrowna => aleksandrovna
alexei => alexeï , alekseï , alexej , alekseĭ , alekséi , aleksei , aleksej , aleksiej , aleksey , alekseý , alexéi
alexej => alexei , alekseï , alekséi , aleksei , aleksej
alexeï => alexei , alekseï , alekseĭ , alekséi , aleksei , aleksej , aleksiej , aleksey , alekseý , alexéi
alexánder => alexander , aleksander , aleksándr , aleksandr , aleksandër
alexéi => alexei , alexeï , alekseï , alekseĭ , alekséi , aleksei , aleksej , aleksiej , aleksey , alekseý
amin => أمين , amīn , αμίν , əmin , امین , amín , амин , آمين , ամին , امين , амін
amir => أمير , амір , əmir , әмир , امير , ամիր , امیر , amír , амир
amín => أمين , amīn , αμίν , əmin , امین , амин , آمين , amin , ամին , امين , амін
amír => أمير , amir , амір , əmir , әмир , امير , ամիր , امیر , амир
amīn => أمين , αμίν , əmin , امین , amín , амин , آمين , amin , ամին , امين , амін
anatoli => анатолій , anatoly , анатоли , anatolij , anatoliy , анатолий
anatolij => анатолій , anatoly , анатоли , anatoli , anatoliy , анатолий
anatoliy => anatoly , anatolij , anatoli
anatoljevitsj => anatolyevich
anatoly => anatolij , anatoliy , anatoli
anatolyevich => anatoljevitsj
andrei => andrey , andreĭ , andriej , andrej , andreï
andrej => андрій , андреј , андрей , andreï , andrei , andrey , андрэй , andreĭ , andréi , andrij
andrew => andy
andrey => andreï , andrei , andrėĭ , andreĭ , andréi , andrej , andréï
andreï => andrei , andrey , andrėĭ , andreĭ , andriej , andréi , andrej , andréï
andreĭ => andréï , andrei , andrey , andrėĭ , andriej , andréi , andrej , andreï
andriej => andreï , andrei , andreĭ
andrij => андрій , андреј , андрей , андрэй , andrej
andréi => andréï , andrėĭ , andrey , andreĭ , andrej , andreï
andréï => andrėĭ , andrey , andreĭ , andréi , andreï
andrėĭ => andréï , andrey , andreĭ , andréi , andreï
andy => енді , أندي , анди , անդի , энди , andrew , アンディ , էնդի , анді , اندی
angel => miguel
anna => マリーア , maría , maria , աննե , anne , марія , mária , анна , μαρία , άννα , мария
anne => աննա , աննե , anna , marie , анна , άννα
anri => anrī , ανρί , анрі , анри , انری , анры , هنري , هنری , آنری , անրի , הנרי , هنرى
anrī => ανρί , анрі , анри , انری , анры , هنري , هنری , آنری , anri , անրի , הנרי , هنرى
anthony => tony
antoine => antonio , antônio , antónio
anton => антонио , antônio , antón , antonio , antónio , антон
antoni => άντονι , antônio , antonio , αντόνιο , antónio , antòni
antonio => άντονι , anton , антонио , antônio , antón , antoine , αντόνιο , antoni , antónio , antòni , антон
antòni => άντονι , antônio , antonio , αντόνιο , antoni , antónio
antón => anton , антонио , antônio , antonio , antónio , антон
antónio => άντονι , anton , антонио , antônio , antón , antoine , antonio , αντόνιο , antoni , antòni , антон
antônio => άντονι , anton , антонио , antón , antoine , antonio , αντόνιο , antoni , antónio , antòni , антон
august => auguste
auguste => august
austria => àustria , autriche , áustria , østrig
autriche => austria
ayan => ایان , حرصي , أيان , այան , هرسی , هرسي , حرسي , ايان , حرصی , آیان , حرسی , آيان
aziz => сауд , səud , азіз , ազիզ , αζίζ , عزیز , азиз , սաուդ , azíz , عزيز , azīz , saüd , саўд , saʿūd , саӏуд , saud
azíz => сауд , səud , азіз , ազիզ , αζίζ , عزیز , азиз , սաուդ , عزيز , azīz , saüd , aziz , саўд , saʿūd , саӏуд , saud
azīz => сауд , səud , азіз , ազիզ , αζίζ , азиз , սաուդ , azíz , saüd , aziz , саўд , saʿūd , саӏуд , saud
aлeксандрович => александрович , олександрович , аляксандравіч
aḥmad => aḥmed , ahmad , ʿahmed , ахмед , àhmad , ahmed , ахмад
aḥmed => aḥmad , ahmad , ʿahmed , ахмед , àhmad , ahmed , ахмад
baron => лорд , john , barone , lord , barón , барон
barone => baron
barón => лорд , baron , барон , lord
bavaria => bayern , baviera , baviere , bavária , bavière , baviére , bavièra
baviera => baviere , bavaria , bavière , bavièra , baviére
baviere => baviera , bayern , beieren , bavaria , bavière , bavièra , baviére
bavièra => baviera , baviere , bavaria , bavière , baviére
bavière => baviera , bayern , beieren , baviere , bavaria , baviére , bavièra
baviére => baviera , bayern , beieren , baviere , bavaria , bavière , bavièra
bavária => bayern , bavaria
bayern => baviere , bavaria , bavária , bavière , baviére
beieren => bavière , baviere , baviére
bernard => бернард , bernhard , бернхард
bernhard => бернард , bernard , бернхард
bill => william
billy => william
bjorn => björn , bjørn
björn => bjorn , bjørn
bjørn => bjorn , björn
borbon => bourbon , bourbón , борбон , burbon , borbón , borbone , бурбон
borbone => bourbon , bourbón , borbon , borbón
borbón => bourbon , bourbón , борбон , burbon , borbone , borbon , бурбон
borisovich => borisovitsj , borissowitsch
borisovitsj => borisovich
borissowitsch => borisovich
bourbon => borbón , bourbón , borbone , borbon
bourbón => bourbon , borbón , borbone , borbon
boyd => بوید , بويد , בויד
brus => بروس , ბრუს , brüs , ברוס , брюс , ブルース , брус
brüs => brus , بروس , ბრუს , брюс , ברוס , ブルース , брус
burbon => borbón , борбон , borbon , бурбон
caio => gayo , gaius , cayo
carl => charles , كارل , karl , կարլ , карл , կառլ , καρλ , کارل
carles => carlos
carlo => charles , karel , karol , karl , carlos
carlos => charles , karel , karl , carlo , carles
carolus => karl , charles
cayo => gaio , caio , gayo , gaius
charles => earl , karel , carlo , karl , carlos , carl , charlie , carolus
charlie => charles
chen => чэнь , çénʹ , chén , чень
chén => чэнь , çénʹ , chen , чень
conde => condé , count
condé => conde , count
conrad => konrad , konrád
constantin => konstantin , konštantín , constantín
constantinopla => constantinople
constantinople => constantinopla
constantín => constantin , konstantin , konštantín
corneli => cornélio , cornelio
cornelio => cornélius , cornélio , corneli , cornelius
cornelis => cornélis , cornélius , cornelius
cornelius => cornelis , cornélis , cornélio , cornélius , cornelio
cornélio => cornélius , corneli , cornelius , cornelio
cornélis => cornélius , cornelis , cornelius
cornélius => cornelis , cornélis , cornélio , cornelio , cornelius
count => condé , conde
daniel => danny
danny => daniel
dari => mária , maría , maria , marià
dave => david , дэйв , дейв
david => давид , дэвид , devid , dave , девід , давід , девид
devid => давид , дэвид , девід , david , давід , девид
dias => دیاز , диаш , diaš , діаш , диас , دياز , діас
diaz => դիաս , dïas , دیاز , diáz , диаз , díaz , დიას , діаз , диас , دياز , діас
diaš => دیاز , диаш , діаш , диас , دياز , dias , діас
dirk => дырк , դիրկ , ديرك , дирк , дірк , دیرک
diáz => դիաս , dïas , диаз , diaz , díaz , დიას , діаз , диас , діас
dmitri => dmitriy , дмитрий , дмитри , dmitry , dmitríj , dmitrij
dmitrievic => dmitrovič , дмитриевич , дмитрович , dmitrievič
dmitrievič => dmitrovič , дмитриевич , дмитрович , dmitrievic
dmitrij => dmitriy , dmitri , дмитрий , дмитри , dmitry , dmitríj
dmitriy => dmitri , dmitrij , dmitry
dmitrovič => dmitrievič , дмитриевич , дмитрович , dmitrievic
dmitry => dmitri , dmitrij , dmitriy
dmitríj => dmitri , dmitrij , дмитрий , дмитри
duca => duke
duce => duke
duke => duque , duce , duca , דוכס
duque => duke
díaz => դիաս , dïas , دیاز , diáz , диаз , diaz , დიას , діаз , диас , دياز , діас
dïas => դիաս , diáz , диаз , diaz , díaz , დიას , діаз , диас , діас
džek => ジャック , джэк , джек
earl => ایرل , ايرل , john , george , charles , henry , jarl , граф , إيرل
eduard => едуард , էդուարդ , эдвард , էդվարդ , eduárd , edvard
eduárd => едуард , էդուարդ , эдвард , էդվարդ , edvard , eduard
edvard => едуард , էդուարդ , эдвард , էդվարդ , eduárd , eduard
ekaterina => екатерина , јекатерина , jekatěrina , jekaterina
elena => јелена , елена , ołena , єлена , olena , олена , jeļena , yelena , jelena
elisabet => élisabeth , élisabet , elisabeth , elisabèt
elisabeth => élisabeth , élisabet , elisabèt , elisabet
elisabèt => élisabeth , élisabet , elisabeth , elisabet
emil => اميل , эмил , أميل , エミール , إميل , エーミル , ემილ , εμίλ , امیل , emile , אמיל , עמיל , έμιλ , էմիլ , емил , émile
emile => emil , émile
emma => эмма , إيما , емма , էմմա , έμμα
emperador => emperor
emperor => emperador
enric => henri
enrico => henri
eric => erik , اريك , ерик , έρικ , эрик , اریک , エリック , éric , أريك , ерік , էրիկ , إريك
erik => اريك , érïk , אריק , ерик , eric , έρικ , эрик , ερίκ , اریک , エリック , éric , أريك , ерік , էրիկ , إريك
ernest => ернст , ернест , эрнест , эрнст , ernst
ernst => ернст , ernest , ернест , эрнест , эрнст
evgeniy => yevgeny , jevgenij , evgenïý
evgenïý => yevgeny , jevgenij , evgeniy
eşli => էշլի , ешли , эшли , ешлі , آشلي , أشلى , ešli , اشلی , эшлі , اشلي , أشلي
ešli => էշլի , ешли , эшли , ешлі , eşli , آشلي , أشلى , اشلی , эшлі , اشلي , أشلي
federico => friedrich , frédéric , frederic
fedir => фёдор , федір , fedor
fedor => фёдор , федір , fedir
foks => фокс , فوکس , فوكس
ford => форд , فورد , ֆորդ
francis => françis , francois , françois , frank
francisco => francois , françois
francois => françis , francisco , françois , francis
frank => francis
frans => françois
fransoa => франсоа , fransuā , франсуа , fransua
fransua => fransuā , fransoa , франсоа , франсуа
fransuā => франсоа , fransoa , франсуа , fransua
françis => francois , françois , francis
françois => francisco , frans , francis , françis , francois
fred => фрэд , ֆրեդ , フレッド , фред
frederic => friedrich , frederick , frédéric , federico , fredéric
frederick => friedrich , fréderic , frederik , frederic , frédéric , fredéric
frederik => friedrich , фредерик , fredrik , fréderic , frederick , фредрик , frèdèric , frédéric , fredéric
fredrik => фредерик , фредрик , frederik
fredéric => friedrich , fréderic , frederik , frederick , frederic , frèdèric , frédéric
friedrich => heinrich , fréderic , frederik , frederick , frederic , frèdèric , frédéric , federico , fredéric
fryderyk => frédéric
frèdèric => friedrich , fréderic , frederik , frédéric , fredéric
fréderic => friedrich , frederik , frederick , frèdèric , frédéric , fredéric
frédéric => friedrich , fréderic , frederik , frederick , frederic , fryderyk , frèdèric , federico , fredéric
fòng => pave , papa , pápa , pāpa , hông , hoàng , pópù , สมเด , pous , huòng , pope , giáo , paus , pàpa , папа
gaio => gayo , gaius , cayo
gaius => gaio , gayo , caio , cayo
gans => ჰანს , هانس , hans , հանս , ханс , ганс
garcia => maría , garcía , maria
garcía => garcia , maría , maria
gari => гари , غاري , գարի , гарі
gary => غاري , гэри , гері , ґері , гари , გარი , гары , гери , գերի , გერი , գարի , ゲーリー , ゲイリー , гарі
gayo => gaio , caio , gaius , cayo
georg => george , георге , георгэ , karl , карл , ґеорґе , георг
george => георге , earl , georgius , georges , георгэ , ґеорґе , georg , георг
georges => george
georgi => георги , георгі , georgij , георгій , георгиј , георгий
georgij => георги , георгі , георгій , георгиј , георгий , georgi
georgius => george
giovan => giovanni
giovanni => ioannes , giovan , johann
giáo => pave , papa , fòng , pápa , pāpa , hông , pópù , สมเด , pous , pope , paus , pàpa , папа
gonzales => gonzalez , gonzález , gonzáles
gonzalez => gonzales , gonzález , gonzáles
gonzáles => gonzalez , gonzales , gonzález
gonzález => gonzalez , gonzales , gonzáles
gray => грей , غراي , ґрей , грэй , grây , grej , греј
greg => غريغ , գրեգ , грег , грэг , グレッグ , grégory , gregory
gregory => greg , grégory
grej => грей , ґрей , грэй , grây , греј , gray
grây => грей , غراي , ґрей , грэй , grej , греј , gray
grégory => greg , gregory
guglielmo => guilherme
guilherme => guglielmo , wilhelm , guillaume
guillaume => guilherme
gustaf => gustav , gustáv
gustav => gustaf , gustáv
gustáv => gustav , gustaf
haim => حییم , хаїм , haïm , хаім , háim , חיים , حييم , хаим
hall => холл
hans => ჰანს , هانس , johann , հանս , ханс , gans , هانز , ганс
haïm => حییم , хаїм , хаім , háim , haim , חיים , حييم , хаим
heinrich => henry , hendrik , friedrich , henri
hendrik => heinrich , henry , henri
henri => heinrich , henry , enrico , enric , hendrik
henricus => henry
henry => henricus , heinrich , earl , henri , hendrik
herman => херман , hermann , херманн
hermann => херман , херманн , herman
holt => هولت , холт
horn => הורן , հորն , هورن , хорн
hose => hosē , хосе , خوزه
hosē => hose , хосе , خوزه
hoàng => hóng , pous , huòng , pope , hông , hoảng , fòng
hoảng => hông , hoàng , hóng
huan => хуан , خوان , خوآن
hugo => гуґо , гюґо , хюго , хуго , гюго , هوغو , гуго
hunt => հանտ , хант , هانت
huòng => hông , hoàng , fòng
háim => حییم , хаїм , haïm , хаім , haim , חיים , حييم , хаим
hóng => hông , hoảng , hoàng
hông => pave , papa , fòng , pápa , pāpa , hoàng , pópù , hóng , สมเด , pous , pope , huòng , giáo , paus , pàpa , hoảng , папа
igor => იგორ , игор , イゴーリ , ígor , իգոր , igorʹ , イーゴリ , игорь , ігор
igorʹ => игор , игорь , igor
ilia => iliá , ιλιά , илја , ilya , ιλία , իլյա , iļja , iljá , iľja , ilʹâ , илья , ilja , ίλια , i̇lya , ілья , ilià , илия
ilià => iliá , ιλιά , илја , ilya , ilia , ιλία , իլյա , iļja , iljá , iľja , ilʹâ , илья , ilja , ίλια , i̇lya , ілья , илия
iliá => ιλιά , илја , ilya , ilia , ιλία , իլյա , iļja , iljá , iľja , ilʹâ , илья , ilja , ίλια , i̇lya , ілья , ilià , илия
ilja => iliá , ilya , илја , i̇lyä , ιλιά , ilia , իլյա , iļja , iljá , iľja , илья , ilʹâ , ілья , ίλια , i̇lya , ilià
iljá => iliá , ilya , илја , i̇lyä , ιλιά , ilia , ίλια , իլյա , iļja , ilʹâ , iľja , илья , ilja , ілья , i̇lya , ilià
ilya => iliá , i̇lyä , илја , ιλιά , ilia , իլյա , iļja , iljá , iľja , ilʹâ , илья , ilja , ίλια , i̇lya , ілья , ilià , илия
ilʹâ => iliá , ιλιά , илја , ilya , ilia , ιλία , ίλια , iļja , iljá , iľja , илья , ilja , ілья , ilià , илия
ines => agnès , agnes , inês , inés
inés => agnès , agnes , ines , inês
inês => agnès , agnes , ines , inés
ioann => йован , иоанн , i̇oann , іоанн , јован , jovan
ioannes => iōannēs , jóhannes , johannes , giovanni
iulius => julio , júlio
ivan => ívan , iван , イヴァン , йоһан , իվան , ივან , joan , איבן , іванович , ivanovič , îvan , иван , ивaн , ïvan , йоан , іван , ïvanovïç , i̇van , iwan , иванович , iván , ivanovic , îwan
ivanovic => іван , иван , ivanovič , ïvan , иванович , ivan , іванович , ïvanovïç
ivanovich => ivanoviĉ , iwanowitsch , ivanovič , ivanovitsj , i̇vanoviç , ïvanovïç
ivanovitsj => iwanowitsch , ivanovich
ivanoviĉ => ïvanovïç , ivanovich , ivanovič , i̇vanoviç
ivanovič => іван , иван , ivanoviĉ , i̇vanoviç , ïvan , иванович , ivanovic , ivanovich , ivan , іванович , ïvanovïç
iván => ívan , îvan , iван , иван , イヴァン , іван , i̇van , ивaн , iwan , ივან , ïvan , איבן , իվան , ivan , îwan
iwan => ívan , îvan , iван , иван , i̇van , ივან , ïvan , ivan , iván , իվան , іван , îwan
iwanowitsch => ivanovich , ivanovitsj
iļja => iliá , ilya , илја , i̇lyä , ιλιά , ilia , ίλια , իլյա , iljá , iľja , илья , ilʹâ , ilja , ілья , i̇lya , ilià
iľja => iliá , ilya , илја , i̇lyä , ιλιά , ilia , ίλια , իլյա , iļja , iljá , илья , ilʹâ , ilja , ілья , i̇lya , ilià
iōannēs => jóhannes , johannes , ioannes
i̇lya => iliá , i̇lyä , ilya , илја , ιλιά , ilia , իլյա , iļja , iljá , iľja , ilja , ίλια , ilià , илия
i̇lyä => ilya , илја , իլյա , iļja , iljá , iľja , ilja , i̇lya
i̇oann => йован , иоанн , іоанн , ioann , јован , jovan
i̇van => ívan , îvan , iван , иван , iwan , ივან , ïvan , ivan , iván , իվան , іван , îwan
i̇vanoviç => ivanovich , ivanovič , ivanoviĉ , ïvanovïç
iван => ívan , îvan , イヴァン , иван , i̇van , ивaн , iwan , ივან , ïvan , ivan , iván , իվան , іван , îwan
jack => ジャック , john , джэк , джек
jacob => jakob , jakób
jakob => jakób , jacob
jakób => jakob , jacob
james => jimmy
jarl => earl
jean => paul , john , joão , johan , jóhann , ジョアン , johann , joao , јуан , juan , جيان , joseph , йоан , pàul , joan
jekaterina => екатерина , јекатерина , ekaterina , jekatěrina
jekatěrina => екатерина , јекатерина , ekaterina , jekaterina
jelena => јелена , elena , елена , єлена , jeļena , yelena
jesus => jose , jesús , josé
jesús => jose , jesus , josé
jevgenij => yevgeny , evgeniy , evgenïý
jewgeni => yevgeny
jeļena => јелена , elena , елена , єлена , yelena , jelena
jimmy => james
jiri => jiří , іржі , іржи , jirí , иржи , իրժի , їржі , jiři
jirí => jiří , jiri , іржі , іржи , иржи , իրժի , їржі , jiři
jiři => jiří , jiri , іржі , іржи , jirí , иржи , իրժի , їржі
jiří => jiri , іржі , іржи , jirí , иржи , իրժի , їржі , jiři
joan => john , joão , йоһан , иван , jóhann , ジョアン , ジュアン , ջոան , جوان , joao , juan , johann , jean , йоан , ivan , جوآن , йоханн
joao => جواو , joão , جؤاو , joâo , жуан , žoao , ジョアン , ժոաո , јуан , juan , zuan , ζοάο , jean , joäo , joan , ジョアオ , йоан , joáo , joāo , жоао
joel => joël , جويل , جوئل , ջոել , جویل , йоел
johan => john , jóhann , йохан , johann , jean , йоханн
johann => john , johan , jóhann , hans , йохан , giovanni , juan , jean , joan , йоан , johannes , йоханн
johannes => john , jóhannes , johann , ioannes , iōannēs
john => joão , johan , earl , johnny , baron , لاعب , johann , τζον , јуан , juan , джон , jean , joan , joseph , johannes , τζόν , τζων , jack
johnny => john
jorj => ջորջ , ჯორჯ , ジョージ
jose => خوزه , ժոզե , luis , ζοζέ , ジュアン , луїс , xosé , хозе , โฮเซ , jesus , jozef , խոսե , pérez , хуан , juan , хосе , josè , lópez , žoze , жозе , žozē , józef , луис , xose , luís , perez , lopez , jesús , josé , jožef
josef => józef , jósef , jożef , joseph , jozef , jožef
josep => josé , josè
joseph => józef , john , jean , jożef , jozef , josef , jožef
josh => joshua
joshua => josh
josè => խոսե , خوزه , jose , ジュアン , xose , juan , xosé , josé , хосе , ζοζέ , ժոզե , хозе , žoze , โฮเซ , жозе , žozē , josep
josé => خوزه , ժոզե , ζοζέ , luis , josep , ジュアン , луїс , xosé , хозе , โฮเซ , jesus , jozef , խոսե , хуан , juan , хосе , josè , lópez , žoze , жозе , žozē , józef , jose , луис , xose , luís , lopez , jesús , jožef
jovan => йован , i̇oann , іоанн , ioann , јован , иоанн
jozef => józef , jósef , jose , jożef , joseph , josé , josef , jožef
joáo => جؤاو , جواو , joão , joâo , жуан , žoao , ジョアン , ժոաո , joao , zuan , ζοάο , joäo , ジョアオ , йоан , joāo , жоао
joâo => جؤاو , جواو , joão , жуан , ジョアン , joao , zuan , joäo , ジョアオ , йоан , joáo , joāo
joão => јуан , jean , joáo , joan , جؤاو , ժոաո , zuan , ζοάο , joäo , joāo , john , جواو , жуан , joao , juan , ジョアオ , йоан , joâo , žoao , ジョアン , жоао
joäo => جؤاو , جواو , joão , joâo , жуан , žoao , ジョアン , ժոաո , joao , zuan , ζοάο , ジョアオ , йоан , joáo , joāo , жоао
joël => جويل , جوئل , ջոել , جویل , joel , йоел
joāo => جؤاو , جواو , joão , joâo , жуан , ジョアン , joao , zuan , joäo , ジョアオ , йоан , joáo
jożef => józef , jósef , joseph , jozef , josef , jožef
jožef => józef , jósef , jose , jożef , joseph , josé , jozef , josef
juan => john , joão , хуан , ジュアン , jose , јуан , joao , johann , joan , josé , josè , خوآن , jean , خوان
juergen => jürgen , jurgen
julio => júlio , iulius
jungere => jüngere , younger
jurgen => jürgen , juergen
juri => yuri , יורי , юрий , júrij , yury , jurij , يوري , jüri , ûrij , ユーリー , یوری , юрій , јури
jurij => yuri , júrij , yury , juri , juriy
juriy => yury , jurij
jóhann => johan , йохан , johann , jean , йоан , joan , йоханн
jóhannes => iōannēs , johannes , ioannes
jósef => józef , jożef , jozef , josef , jožef
józef => jósef , jose , jożef , joseph , josé , jozef , josef , jožef
júlio => julio , iulius
júrij => yuri , yury , jurij , juri
jüngere => jungere , younger
jürgen => jurgen , juergen
jüri => ûrij , юрий , juri , юрій
karel => charles , карел , karol , carlo , karl , carlos , карл
karl => károly , karoly , karel , carlos , კარლ , georg , καρλ , otto , отто , كارل , オットー , carl , կարլ , קארל , կառլ , георг , کارل , charles , карл , carolus , карол , карел , karol , carlo
karol => карол , karel , carlo , karl , карл
karoly => karl , károly
kate => кэйт , kejt , кейт , кејт
kato => kató , کاتو , като , katō , كاتو
kató => کاتو , kato , като , katō , كاتو
katō => kató , کاتو , kato , като , كاتو
kejt => кэйт , кейт , кејт , kate
kent => كينت , کینت , кент
keri => кэри , كارى , кери , кері , كاري
king => кинг , کینگ , كينغ , кінг
kirk => كيرك , кирк , кірк , կիրկ
klod => клод , كلود , کلود , クロード , կլոդ
koen => κοέν , κόεν , کوهن , коен , كوهن , коэн
koji => کوجی , կոջի , kōji , كوجي , kôji
konrad => conrad , konrád
konrád => conrad , konrad
konstantin => constantin , konštantín , constantín
konštantín => constantin , konstantin , constantín
kris => крис , کریس , крыс , כריס , كريس , кріс , κρις
kurt => курт , كورت , کورت
kyle => كايل , کایل , կայլ
károly => karoly , karl
kôji => کوجی , կոջի , kōji , koji , كوجي
kōji => کوجی , կոջի , koji , كوجي , kôji
lang => ланг , لانغ , լանգ , láng
leon => папа , león , pàpa , լեոն , لیون , леон , papa , léon , pápa , λεόν , لئون , ليون , λέων , λέον
león => папа , pàpa , լեոն , لیون , леон , papa , léon , pápa , λεόν , leon , لئون , ليون , λέων , λέον
liam => ліям , лиам , լիամ , ليام , ліам , لیام , λίαμ
lila => ᕤᐒᓄᔅ , ლილა , ܕܘܢܤ , ліла , ліля , ዶወንሡ , ዾውንስ , ܠܝܠܐ , լիլա , λίλα , ዳውንስ , лила
lima => лима , լիմա , لیما , ліма , ليما
lisa => лиса , liza , ლიზა , ліза , լիզա , лиза , ليزا , λίζα , līsa , līza , لیزا
liza => лиса , lisa , ლიზა , ліза , լիզա , лиза , ليزا , λίζα , līsa , līza , لیزا
ljudmila => lyudmila
lluis => lluís , luís , louis , luis
lluís => lluis , luís , louis , luis
lodewijk => ludwig
lopez => jose , josé , lópez
lord => лорд , baron , барон , barón
lori => лори , лорі , لوري , λόρι , לורי , لوری
louis => luiĝi , lluís , luigi , lluis , luís , marie , luis , ludwik , ludwig
louise => luisa , marie , luísa
luci => lucius , lúcio , lucio
lucio => lucius , luci , lúcio
lucius => luci , lúcio , luçio , lucio
ludvig => luís , luis
ludvik => luis , ludvík , luís
ludvík => luis , ludvik , luís
ludwig => luis , luís , lodewijk , louis
ludwik => luis , louis , luís
luigi => luiĝi , luís , louis , luis
luis => lluís , lluis , لويس , луіш , луíс , луїш , luiş , luigi , لویس , ludvik , луїс , луіс , ludwik , ludwig , lüis , ludvig , louis , люис , jose , луис , ludvík , luís , josé , луиш
luisa => maría , maria , mária , louise , luísa
luiz => луїш , луис , люіс , luís , луїс , луиз , луіс , luíz , луиш
luiĝi => luigi , louis
luiş => луíс , луїш , لویس , луис , لويس , luís , луїс , луіс , luis , луіш , lüis , луиш , люис
luka => lwka , люка , лука , lūka , لوکا , لوكا
luçio => lucius , lúcio
luís => lluís , lluis , لويس , luis , луіш , luíz , луíс , луїш , luiş , luigi , لویس , ludvik , луїс , луиз , луіс , ludwik , luiz , ludwig , lüis , ludvig , louis , люис , jose , луис , люіс , ludvík , josé , луиш
luísa => maría , maria , mária , luisa , louise
luíz => луїш , луис , люіс , luís , луїс , луиз , луіс , luiz , луиш
lwka => luka , люка , лука , lūka , لوکا , لوكا
lyudmila => ljudmila
láng => ланг , لانغ , lang , լանգ
léon => папа , león , pàpa , լեոն , لیون , леон , papa , pápa , λεόν , leon , لئون , ليون , λέων , λέον
lópez => jose , lopez , josé
lúcio => lucius , luci , luçio , lucio
lüis => луíс , луїш , luiş , لویس , луис , لويس , luís , луїс , луіс , luis , луіш , луиш , люис
līsa => лиса , liza , lisa , ლიზა , ліза , լիզա , лиза , ليزا , λίζα , līza , لیزا
līza => лиса , liza , lisa , ლიზა , ліза , լիզա , лиза , ليزا , λίζα , līsa , لیزا
lūka => lwka , luka , люка , лука , لوکا , لوكا
majk => mayk , مايك , մայկ , مایک , майк , мајк
maks => マックス , ماكس , ماکس , მაქს , макс
marc => մարկ , مارك , μαρκ , mark , марк , مارک , marcus , μάρκ
marco => marcus
marcus => marco , marc
mari => մարի , ماری , mary , марі , ماري , μαρί , мари , мары , مارى
maria => マリーア , dari , marija , garcia , марыя , marià , мария , maría , marya , teresa , άννα , марія , mária , анна , μαρία , luisa , garcía , марија , anna , marie , мариа , luísa
marie => maría , maria , anne , марія , louis , mária , marìa , марие , louise , мария
marija => марија , maría , maria , марія , mária , мариа , мария
marià => dari , maría , maria , mária
mark => מארק , marc , մարկ , مارك , μαρκ , მარკ , марк , مارک , μάρκ
mary => մարի , ماری , meri , мэри , mari , მერი , մերի , мери , марі , ماري , μαρί , メアリー , мари , μέρι , мері , мары , مارى
marya => мариа , марыя , maria , мария
marìa => maría , марія , marie , mária , марие , мария
maría => マリーア , dari , marija , garcia , marìa , марие , marià , мария , teresa , άννα , maria , марія , mária , анна , μαρία , luisa , garcía , марија , anna , marie , luísa
master => meister
matt => мэтт , matthew , метт
matthew => matt
mayk => مايك , մայկ , majk , مایک , майк , мајк
meister => master
meri => ماری , мэри , მერი , մերի , mary , мери , メアリー , μέρι , мері , مارى , ماري
michael => mike , mikhail , mikhaïl , michaël , michel
michail => miĥail , mikhail , mihail , mikhaïl , michaił , mikhaḯl
michailowitsch => michaylovitsj
michaił => miĥail , mikhail , michail , mihail , mikhaïl , mikhaḯl
michaylovitsj => mikhajlovitsj , michailowitsch , mikhaylovich
michaël => michael , mikhaïl , michel , mikhail
michel => michael , michaël
miguel => angel , àngel , ángel
mihail => mihaíl , mihajlo , михайло , miĥail , michail , mikhail , михајло , михаил , mikhaïl , michaił , михаїл
mihajlo => михайло , mihail , михајло , михаил , михаїл
mihaíl => mikhaïl , mikhail , mihail
mijail => mijaíl , mikhaïl , mikhail
mijaíl => mikhaïl , mikhail , mijail
mikalaj => nikołaj , nikolaj , николај , николай , mikałaj , мікалай
mikałaj => nikołaj , nikolaj , mikalaj , николај , николай , мікалай
mike => مايك , michael , մայկ , міке , مایک , мике , майк , мајк
mikhail => mihaíl , michael , mijaíl , michail , mihail , mikhaïl , michaił , mikhaḯl , michaël , mijail
mikhajlovitsj => michaylovitsj , mikhaylovich
mikhaylovich => mikhajlovitsj , michaylovitsj
mikhaïl => mihaíl , michael , mijaíl , mikhail , michail , mihail , michaił , mikhaḯl , michaël , mijail
mikhaḯl => mikhaïl , michaił , mikhail , michail
miki => μίκι , միկի , мікі , میکی , мики , ميكي
mikola => микола , николáй , mikoła , nikołaj , nikolaj , мікола , николај , николай
mikoła => mikola , николáй , микола , nikołaj , nikolaj , мікола , николај , николай
miĥail => michaił , michail , mihail
mohamed => мухаммед , muhàmmad , муhаммед , muhámmad , muḥammad , мохамед , muhammad , muḩammad , мохаммед , мухаммад , mohámed , мухӏаммад , muħammed , muhammed , mohammed
mohammad => muhàmmad , muḥammad , muhammad , muḩammad , мухӏаммад , мохаммад
mohammed => muhàmmad , muhámmad , mohámmed , мохаммед , muhammad , muḥammad , muḩammad , mohamed , мухаммад , мохамед , muħammed , muhammed , мухаммед
mohámed => muhàmmad , муhаммед , muhámmad , mohamed , muhammad , мохамед , muḥammad , muḩammad , мухаммад , muħammed , мухӏаммад , muhammed , мухаммед
mohámmed => muhàmmad , muhámmad , muḥammad , мохаммед , muhammad , muḩammad , мухаммад , mohammed
mori => موري , mōri , موری , морі , մորի , мори , מורי
mueller => muller , müller
muhammad => мухаммед , muhàmmad , muhámmad , mohámmed , muḥammad , мохаммед , mohamed , muḩammad , мохамед , мухаммад , mohámed , мухӏаммад , muħammed , muhammed , mohammed , мохаммад , mohammad
muhammed => muhàmmad , муhаммед , мохаммед , muhammad , muħammed , mohamed , мохамед , мухаммад , mohámed , mohammed , мухаммед
muhàmmad => мухаммед , muhámmad , mohámmed , muḥammad , мохаммед , muhammad , muḩammad , mohamed , мухаммад , мохамед , mohámed , мухӏаммад , muħammed , muhammed , mohammed , мохаммад , mohammad
muhámmad => muhàmmad , mohámmed , muḥammad , мохаммед , muhammad , muḩammad , mohamed , мухаммад , мохамед , mohámed , мухӏаммад , mohammed
muller => müller , mueller
musa => mūsā , موسی , муса , موسي , موسى
muħammed => muhàmmad , муhаммед , мохаммед , muhammad , mohamed , muhammed , мохамед , мухаммад , mohámed , mohammed , мухаммед
muḥammad => muhàmmad , muhámmad , mohámmed , мохаммед , muhammad , mohamed , muḩammad , мохамед , мухаммад , mohámed , мухӏаммад , mohammed , мохаммад , mohammad
muḩammad => muhàmmad , muhámmad , mohámmed , мохаммед , muhammad , muḥammad , mohamed , мохамед , мухаммад , mohámed , мухӏаммад , mohammed , мохаммад , mohammad
mária => マリーア , dari , марија , maría , maria , marija , марія , anna , marie , анна , μαρία , luisa , luísa , marìa , marià , teresa , марие , άννα , мария
müller => muller , mueller
mōri => موري , موری , морі , mori , մորի , мори , מורי
mūsā => musa , موسی , муса , موسي , موسى
niccolo => niccoló , nicolo , nicolò , niccolò
niccolò => niccoló , niccolo , nicolo , nicolò
niccoló => niccolo , nicolo , nicolò , niccolò
nicholas => nicolas , nicolás
nicolai => nikolaĭ , nicolaï , nikolaï , nikolai , nikolái , nikołaj , nicolaĭ , nikolaj
nicolas => nikolaus , nicolás , nicholas
nicolaï => nikolaĭ , nikolaï , nicolai , nikolai , nikolái , nikołaj , nicolaĭ , nikolaj
nicolaĭ => nikolaĭ , nicolaï , nikolaï , nicolai , nikolai , nikolái , nikołaj , nikolaj
nicolo => niccoló , niccolo , nicolò , niccolò
nicolás => nicolas , nikolaus , nicholas
nicolò => niccoló , niccolo , nicolo , niccolò
nikolaevitsj => nikolajevitsj , nikolayevich , nikolajewitsch
nikolaevič => николáй , николаевич , nikolaj , николај , николай , николáeвич
nikolai => nikolaĭ , nicolaï , nikolaï , nicolai , nikolái , nikołaj , nicolaĭ , nikolaj , nïkolaý , nyikolaj , nikoláj , nikolay
nikolaj => nikolaĭ , nicolaï , mikoła , nikołaj , mikalaj , nikolay , nikoláï , mikola , nicolai , nicolaĭ , nikoláj , мікалай , николáй , nikolaï , николаевич , nïkolaý , николáeвич , mikałaj , nikolaevič , микола , nikolai , nikolái , мікола , николај , николай
nikolajevitsj => nikolajewitsch , nikolayevich , nikolaevitsj
nikolajewitsch => nikolajevitsj , nikolayevich , nikolaevitsj
nikolaus => nicolas , nicolás
nikolay => nikolaĭ , nikolaï , nikolai , nikolái , nikołaj , nïkolaý , nikolaj , nikoláj , nikoláï
nikolayevich => nikolajevitsj , nikolajewitsch , nikolaevitsj
nikolaï => nikolaĭ , nicolaï , nicolai , nikolai , nikolái , nikołaj , nicolaĭ , nikolaj , nïkolaý , nyikolaj , nikoláj , nikolay , nikoláï
nikolaĭ => nicolaï , nikolaï , nicolai , nikolai , nikolái , nikołaj , nicolaĭ , nikolaj , nyikolaj , nikoláj , nikolay , nikoláï
nikolái => nikolaĭ , nicolaï , nikolaï , nicolai , nikolai , nikołaj , nicolaĭ , nikolaj , nïkolaý , nyikolaj , nikoláj , nikolay , nikoláï
nikoláj => nikolaĭ , nikolaï , nikolai , nikolái , nikołaj , nikolaj , nikolay
nikoláï => nikolaĭ , nikolaï , nikolái , nikolaj , nikolay
nikołaj => nikolaĭ , nicolaï , mikoła , nikolaj , mikalaj , nikolay , mikola , nicolai , nicolaĭ , nikoláj , мікалай , николáй , nikolaï , nïkolaý , mikałaj , микола , nikolai , nikolái , мікола , николај , николай
nina => نينا , нина , նինա , ніна , nīnà , نینا
nino => نینو , نينو , נינו , ніно , նինո , νίνο , нино , niño
niño => نینو , نينو , נינו , ніно , նինո , nino , νίνο , нино
noel => νοέλ , نويل , noèl , նոել , ноел , ноэл , νόελ , نوئل , noël , nöel
noèl => νοέλ , noel , نويل , նոել , ноел , ноэл , νόελ , نوئل , noël , nöel
noël => νοέλ , noel , نويل , noèl , նոել , ноел , ноэл , νόελ , نوئل , nöel
nyikolaj => nikolai , nikolaĭ , nikolaï , nikolái
nïkolaý => nikolaï , nikolai , nikolái , nikołaj , nikolaj , nikolay
nöel => νοέλ , noel , نويل , noèl , նոել , ноел , ноэл , نوئل , noël , νόελ
nīnà => نينا , нина , նինա , ніна , نینا , nina
oleksandr => олександр , александр , aleksandr , ołeksandr , алєксандр
oleksij => алексеј , алексей , aleksej , олексій , ołeksij
olena => олена , ołena , elena , елена
omar => ʿumar , ömər , umar , უმარ , ӏумар , omár , ομάρ , ʿomar , úmar , умар , омар
omár => ʿumar , ömər , omar , umar , უმარ , ӏумар , ομάρ , ʿomar , úmar , умар , омар
otto => отто , օտտօ , όττο , اوتو , אוטו , كارل , オットー , karl , ottó , карл , օտտո , أوتو , καρλ , کارل
ottó => отто , օտտօ , όττο , اوتو , אוטו , օտտո , أوتو , otto
ołeksandr => oleksandr , олександр , александр , aleksandr , алєксандр
ołeksij => oleksij , алексеј , алексей , aleksej , олексій
ołena => олена , elena , елена , olena
pacha => pachá , paša , pașa , pasa , pachà , paşa
pachà => pachá , paša , pacha , pașa , pasa , paşa
pachá => paša , pacha , pașa , pasa , pachà , paşa
paixa => paša , pașa , pasa , paixà , paşa
paixà => paša , paixa , pașa , pasa , paşa
papa => león , papież , papež , pave , fòng , léon , pápa , pāpa , hông , pópù , สมเด , pápež , pous , giáo , pope , paus , pàpa , leon , λέων , папа
pape => pápa , pāpa , папа , pàpa
papež => papież , pave , papa , pápa , pāpa , pópù , pápež , pous , pope , paus , pàpa
papież => pave , papež , papa , pápa , pāpa , pópù , pope , paus , pàpa
pasa => پاشا , паша , pasha , paša , pachá , պաշա , pacha , paixa , pașa , باشا , pachà , paixà , πασά , ფაშა , paşa
pasha => پاشا , паша , paša , պաշա , pașa , pasa , ფაშა , paşa
paul => باول , поль , paulus , jean , pàul , паул
paulus => paul
paus => papież , papež , pave , papa , fòng , pápa , pāpa , hông , pópù , สมเด , pous , giáo , pope , pàpa , папа
pave => papież , papež , papa , fòng , pápa , pāpa , hông , pópù , สมเด , pous , giáo , pope , paus , pàpa , папа
pavel => paweł , pavlo , павло , павел , pawel
pavlo => павел , павло , pavel
pavlovich => pawlowitsch , pavlovitsj
pavlovitsj => pavlovich
pawel => paweł , pavel
paweł => pawel , pavel
pawlowitsch => pavlovich
paşa => پاشا , паша , pasha , paša , pachá , պաշա , pacha , paixa , pașa , pasa , باشا , pachà , paixà , πασά , ფაშა
paša => پاشا , паша , pasha , pachá , pacha , պաշա , paixa , pașa , pasa , باشا , pachà , paixà , πασά , ფაშა , paşa
pașa => پاشا , паша , pasha , paša , pachá , պաշա , pacha , paixa , pasa , باشا , pachà , paixà , πασά , ფაშა , paşa
pedro => peter , pierre , péter
perez => jose , pérez
petar => петар , petr , пётр , пётар , петр
peter => péter , pedro , piotr , pietro , pëtr , pêtr , pětr , петер , petr , петĕр , pierre , пётр , petrus , петр
petr => петро , pëtr , pêtr , pětr , петер , петар , peter , petro , пëтр , петĕр , petar , пётр , пётар , петр
petro => петро , pëtr , petr , пëтр , пётр , петр
petrovich => petrovitsj , petrovítsj , petrowitsch
petrovitsj => petrovítsj , petrovich , petrowitsch
petrovítsj => petrovitsj , petrovich , petrowitsch
petrowitsch => petrovitsj , petrovítsj , petrovich
petrus => pierre , peter
pier => пиер , πιερ , πιέρ , пьер , պիեռ , ピエール , պիեր
pierre => peter , pedro , pietro , petrus
pietro => pierre , peter
piotr => peter
pjotr => pyotr , pýotr
pope => papież , papež , pave , papa , fòng , pápa , pāpa , hông , hoàng , pópù , สมเด , pous , giáo , paus , pàpa , папа
pous => папа , pave , papež , papa , pápa , pāpa , hông , hoàng , pópù , สมเด , giáo , pope , paus , pàpa , fòng
prince => principe , príncipe
princess => prințesa , prinţesa , prinţesă , prințesă
principe => prince , príncipe
prinţesa => prințesa , prinţesă , princess , prințesă
prinţesă => prințesa , prinţesa , princess , prințesă
prințesa => prinţesa , prinţesă , princess , prințesă
prințesă => prințesa , prinţesa , prinţesă , princess
príncipe => prince , principe
publi => públio , publio
publio => públio , publius , publi
publius => publio
pyotr => pjotr , pýotr
pàpa => león , pave , papież , papež , papa , léon , pápa , pāpa , hông , pópù , สมเด , pous , pape , giáo , pope , paus , fòng , leon , λέων , папа
pàul => paul , jean
pápa => león , pave , pous , leon , hông , fòng , สมเด , pape , léon , papež , pápež , pope , pàpa , λέων , папа , papież , papa , pāpa , pópù , giáo , paus
pápež => pápa , papež , pópù , papa
pérez => jose , perez
péter => peter , pedro
pêtr => pëtr , pětr , петер , peter , petr , петĕр , пётр , петр
pëtr => петро , pětr , pêtr , петер , peter , petro , petr , петĕр , пётр , петр
pópù => papież , papež , pave , papa , fòng , pápa , pāpa , hông , สมเด , pápež , pous , giáo , pope , paus , pàpa , папа
públio => publi , publio
pýotr => pjotr , pyotr
pāpa => pave , papież , papež , papa , fòng , pápa , hông , pópù , สมเด , pous , pape , giáo , pope , paus , pàpa , папа
pětr => pëtr , pêtr , петер , peter , petr , петĕр , пётр , петр
quint => quintus , quinto
quinto => quint , quintus
quintus => quint , quinto
rajs => رايس , рајс , ռայս , rays , رایس , райс , رائس
rays => رايس , рајс , ռայս , rajs , رایس , райс , رائس
rice => رايس , رایس , ռայս , رائس
riki => рікі , ریکی , рики , ريكي , ռիկի , ρίκι
rita => ریتا , ріта , ريتا , ռիտա , рыта , рита , ρίτα
rose => rouz , роўз , როუზ , роуз , rosé , росе
rosé => rouz , роўз , rose , როუზ , роуз , росе
rouz => როუზ , роўз , rose , роуз , rosé , росе
rudolf => rudolph
rudolph => rudolf
rusiei => russia , rússia
russia => rusiei , rússia
ryan => ライアン , ریان , ريان
rússia => rusiei , russia
sachsen => saxe , saksen
said => səid , saïd , սաիդ , سعيد , саід , saíd , سعید , саїд , саид , سەید
saint => svätý , szent , svatý , sant
saksen => saxe , sassonia , sachsen , sassònia
sant => saint
sara => սարա , сара , سارة , սառա , sára , سارا , σάρα
sassonia => saxònia , saxónia , saksen , saxônia , sassònia , saxonia
sassònia => saxònia , saxónia , saksen , saxônia , sassonia , saxonia
sato => satō , сато , sató , satô , ساتو
satou => satō , satô , sató
sató => satō , сато , sato , satou , satô , ساتو
satô => satō , сато , sato , sató , satou , ساتو
satō => сато , sato , sató , satou , satô , ساتو
saud => сауд , səud , азіз , ազիզ , αζίζ , азиз , սաուդ , azíz , azīz , saüd , aziz , саўд , saʿūd , саӏуд
saxe => saxònia , sachsen , saxónia , saksen , saxônia , saxonia
saxonia => saxònia , saxónia , saxe , saxônia , sassònia , sassonia
saxònia => saxónia , saxe , saxônia , sassònia , sassonia , saxonia
saxónia => saxònia , saxe , saxônia , sassònia , sassonia , saxonia
saxônia => saxònia , saxónia , saxe , sassònia , sassonia , saxonia
saíd => səid , saïd , սաիդ , said , саід , سعيد , سعید , саїд , саид , سەید
saïd => səid , սաիդ , said , саід , saíd , سعيد , سعید , саїд , саид , سەید
saüd => сауд , səud , азіз , ազիզ , αζίζ , азиз , սաուդ , azíz , azīz , aziz , саўд , saʿūd , саӏуд , saud
saʿūd => сауд , səud , азіз , ազիզ , αζίζ , азиз , սաուդ , azíz , azīz , saüd , aziz , саўд , саӏуд , saud
sergeevitsj => sergejevitsj , sergeyevich
sergei => sergéj , sergey , sergeï , sergeĭ , siergiej , sergueï , serguéi , sergéi , serguei , sergeý , sergej
sergej => sergéj , sergey , siergiej , sergueï , serguéi , serguei , sergei , sergeý
sergejevitsj => sergeevitsj , sergeyevich
sergejewitsch => sergeyevich
sergey => sergeï , siergiej , sergueï , serguéi , serguei , sergei , sergeý , sergej
sergeyevich => sergejewitsch , sergeevitsj , sergejevitsj
sergeï => sergey , sergeĭ , siergiej , sergueï , serguéi , sergéi , serguei , sergei , sergeý
sergeý => sergey , sergeï , siergiej , sergueï , serguéi , serguei , sergei , sergej
sergeĭ => sergeï , siergiej , sergueï , serguéi , sergéi , serguei , sergei
serguei => sergey , sergeï , sergeĭ , siergiej , sergueï , serguéi , sergei , sergeý , sergej
sergueï => sergey , sergeï , sergeĭ , siergiej , serguéi , serguei , sergei , sergeý , sergej
serguéi => sergey , sergeï , sergeĭ , siergiej , sergueï , serguei , sergei , sergeý , sergej
sergéi => sergei , sergeï , siergiej , sergeĭ
sergéj => sergei , siergiej , sergej
siergiej => sergéj , sergey , sergeï , sergeĭ , sergueï , serguéi , sergéi , serguei , sergei , sergeý , sergej
smit => смит , سميث , سمیت , сміт , سمیث , سميت , סמית
sofia => žofia , sophie , zofia , sófia , sofía
sofía => žofia , sophie , zofia , sófia , sofia
sophie => sofia , sofía
stephen => steve
steve => stephen , steven
steven => steve
stiv => ستيف , სთივ , ստիվ , стив , սթիվ , სტივ , סטיב , стів
suecia => suécia , svezia , suècia
suècia => suécia , suecia , svezia
suécia => suecia , svezia , suècia
svatý => svätý , saint
sven => свен , سفين , սվեն
svezia => suécia , suecia , suècia
svätý => saint , svatý
szent => saint
sára => սարա , сара , sara , سارة , սառա , سارا , σάρα
sófia => sofia , žofia , sofía , zofia
səid => saïd , սաիդ , said , саід , saíd , سعيد , سعید , саїд , саид , سەید
səud => сауд , азіз , ազիզ , αζίζ , азиз , սաուդ , azíz , azīz , saüd , aziz , саўд , saʿūd , саӏуд , saud
tatjana => tatyana
tatyana => tatjana
teresa => mária , maría , maria
thomas => tomaš , tomas , tomás , thomàs , tomàs , thomás , tomáš
thomàs => tomaš , tomas , thomas , tomás , tomàs , thomás , tomáš
thomás => tomaš , tomas , thomas , tomás , thomàs , tomàs , tomáš
tomas => tomaš , thomas , tomás , thomàs , tomàs , thomás , tomáš
tomaš => tomas , thomas , tomás , thomàs , tomàs , thomás , tomáš
tomàs => tomaš , tomas , thomas , tomás , thomàs , thomás , tomáš
tomás => tomaš , tomas , thomas , thomàs , tomàs , thomás , tomáš
tomáš => tomaš , tomas , thomas , tomás , thomàs , tomàs , thomás
toni => توني , טוני , تونی , тоні , τόνι , تونى , тони , طوني
tony => توني , טוני , anthony , تونى , τόνι , тоні , تونی , тони , طوني
umar => ʿumar , ömər , omar , უმარ , ӏумар , omár , ομάρ , ʿomar , úmar , умар , омар
valeri => валерий , valerij , валери , валерій , валериј
valerij => валерий , valeriy , валери , valeri , valerïý , valéry , валерій , валериј , valery
valeriy => valerij , valery , valéry , valerïý
valery => valerij , valéry , valeriy , waleri
valerïý => valerij , valeriy
valéry => valerij , valery , valeriy , waleri
vasilevitsj => vasiljevitsj , vasilyevich
vasiljevitsj => vasilevitsj , vasilyevich
vasily => wassili
vasilyevich => vasilevitsj , vasiljevitsj
vera => فيرا , вера , věra , վերա , فیرا
victor => viktor , víktor
viktor => wiktor , victor , víktor
viktorovich => viktorovitsj
viktorovitsj => viktorovich , wiktorowitsch
vilhelm => вільгельм , вилхелм , wilhelm , вильгельм , vilʹgelʹm
vilʹgelʹm => вильгельм , vilhelm , вільгельм , вилхелм
vladimir => vlagyimir , владимирович , владимир , volodímir , vladimír , wladimir , уладзимир , vladimírovič , уладзімір , володимир , владімір , vladimirovič , ŭładzimir , władimir , volodimir , vladïmïr , vladímir
vladimirovich => wladimirowitsch , vladimirovitsj
vladimirovitsj => wladimirowitsch , vladimirovich
vladimirovič => владимирович , владимир , vladimír , vladimir , vladimírovič
vladimirovna => vladímirovna , wladimirowna
vladimír => vlagyimir , владимирович , владимир , vladimir , wladimir , vladimírovič , vladimirovič , władimir , vladïmïr , vladímir
vladimírovič => владимирович , владимир , vladimír , vladimir , vladimirovič
vladímir => vlagyimir , владимир , volodímir , vladimír , vladimir , wladimir , володимир , владімір , władimir , volodimir , vladïmïr
vladímirovna => vladimirovna , wladimirowna
vladïmïr => vlagyimir , vladimír , vladimir , wladimir , władimir , vladímir
vlagyimir => vladimir , vladimír , vladïmïr , vladímir
volodimir => владимир , volodímir , vladimir , володимир , владімір , vladímir
volodímir => владимир , vladimir , володимир , владімір , volodimir , vladímir
víktor => wiktor , viktor , victor
věra => فيرا , вера , վերա , فیرا , vera
vương => wang
waleri => valery , valéry
wang => vương
ward => وارد , ウォード , уорд
wassili => vasily
wiktor => viktor , víktor
wiktorowitsch => viktorovitsj
wilhelm => william , willem , guilherme , vilhelm
willem => william , wilhelm
william => billy , wilhelm , willem , bill
wladimir => vladimír , vladimir , władimir , vladïmïr , vladímir
wladimirowitsch => vladimirovich , vladimirovitsj
wladimirowna => vladimirovna , vladímirovna
wolf => وولف
wurtemberg => württemberg , wurttemberg , würtemberg
wurttemberg => württemberg , wurtemberg , würtemberg
würtemberg => württemberg , wurtemberg , wurttemberg
württemberg => wurtemberg , wurttemberg , würtemberg
władimir => vladimír , vladimir , wladimir , vladïmïr , vladímir
xose => jose , xosé , josé , josè , խոսե
xosé => jose , xose , josé , josè , խոսե
yelena => jelena , elena , jeļena
yevgeny => jevgenij , evgeniy , jewgeni , evgenïý
younger => jungere , jüngere
yuki => يوكي , یوکی , yûki , yūki
yuri => יורי , юрий , júrij , jurij , يوري , ûrij , ユーリー , یوری , юрій , juri , јури
yury => júrij , юрий , jurij , juriy , юрій , juri
yûki => yuki , یوکی , yūki , يوكي
yūki => yuki , یوکی , yûki , يوكي
zofia => sofia , sófia , žofia , sofía
zuan => жуан , joão , joâo , joao , joäo , joáo , joāo
àhmad => aḥmad , aḥmed , ahmad , ʿahmed , ахмед , ahmed , ахмад
àlex => 亞力克斯 , alex , الکس , ألكس , آلکس , 亞歴克斯 , 亚历克斯 , 亚力克斯 , άλεξ , 亞歷克斯 , álex
àngel => miguel , ángel
àustria => østrig , austria , áustria
álex => 亞力克斯 , alex , الکس , àlex , ألكس , آلکس , 亞歴克斯 , 亚历克斯 , 亚力克斯 , άλεξ , 亞歷克斯
ángel => miguel , àngel
áustria => àustria , austria , østrig
çénʹ => чэнь , chen , chén , чень
élisabet => élisabeth , elisabeth , elisabèt , elisabet
élisabeth => élisabet , elisabeth , elisabèt , elisabet
émile => emile , emil
éric => erik , اريك , ерик , eric , έρικ , эрик , اریک , エリック , أريك , ерік , էրիկ , إريك
érïk => erik , ерик , έρικ , эрик , ερίκ , אריק , ерік , էրիկ
ígor => იგორ , игор , イゴーリ , իգոր , igor , イーゴリ , ігор
ívan => iван , îvan , イヴァン , иван , i̇van , ивaн , iwan , ივან , ïvan , איבן , ivan , iván , իվան , іван , îwan
îvan => ívan , iван , イヴァン , иван , i̇van , ивaн , iwan , ივან , ïvan , איבן , ivan , iván , իվան , іван , îwan
îwan => ívan , îvan , iван , иван , i̇van , iwan , ივან , ïvan , ivan , iván , իվան , іван
ïvan => ívan , îvan , iван , иван , i̇van , イヴァン , ivanovic , ивaн , iwan , ივან , ïvanovïç , ivanovič , иванович , ivan , iván , իվան , іван , іванович , îwan
ïvanovïç => іван , иван , ivanoviĉ , i̇vanoviç , ivanovič , ïvan , иванович , ivanovic , ivanovich , ivan , іванович
ömər => ʿumar , omar , umar , უმარ , ӏумар , omár , ομάρ , ʿomar , úmar , умар , омар
østrig => àustria , austria , áustria
úmar => ʿumar , ömər , omar , umar , უმარ , ӏумар , omár , ομάρ , ʿomar , умар , омар
ûrij => yuri , юрий , jüri , юрій , juri
şarl => շառլ , шарл , შარლ , שארל , շարլ , σαρλ , シャルル , šarl , σάρλ , شارل
šarl => շառլ , шарл , შარლ , שארל , շարլ , σαρλ , シャルル , şarl , σάρλ , شارل
šmid => шмід , شميد , шмид
ŭładzimir => vladimir , уладзімір , владимир , уладзимир
žoao => joão , ժոաո , joao , ζοάο , joäo , joáo , жоао
žofia => sofia , sófia , sofía , zofia
žorž => ժորժ , ζωρζ , жорж , ζορζ , جورج , ƶorƶ
žoze => jose , josé , josè , ζοζέ , ժոզե , жозе , žozē
žozē => ζοζέ , jose , ժոզե , josé , josè , žoze , жозе
ƶorƶ => ժորժ , ζωρζ , žorž , жорж , جورج , ζορζ
əmin => أمين , amīn , αμίν , امین , amín , амин , آمين , amin , ամին , امين , амін
əmir => أمير , amir , амір , امير , әмир , ամիր , امیر , amír , амир
ʿahmed => aḥmad , aḥmed , ahmad , ахмед , àhmad , ahmed , ахмад
ʿomar => ʿumar , ömər , omar , umar , უმარ , ӏумар , omár , ομάρ , úmar , умар , омар
ʿumar => ömər , omar , umar , უმარ , ӏумар , omár , ομάρ , ʿomar , úmar , умар , омар
άλεξ => 亞力克斯 , alex , الکس , àlex , ألكس , آلکس , 亞歴克斯 , 亚历克斯 , 亚力克斯 , 亞歷克斯 , álex
άννα => マリーア , աննա , maría , maria , anne , марія , anna , mária , анна , μαρία , мария
άντονι => antônio , antonio , αντόνιο , antoni , antónio , antòni
έμιλ => اميل , эмил , أميل , エミール , إميل , エーミル , ემილ , εμίλ , امیل , emil , אמיל , עמיל , էմիլ , емил
έμμα => emma , эмма , إيما , էմմա , емма
έρικ => erik , اريك , érïk , אריק , ерик , eric , эрик , ερίκ , اریک , エリック , éric , أريك , ерік , էրիկ , إريك
ίλια => iliá , ιλιά , илја , ilya , ilia , ιλία , իլյա , iļja , iljá , iľja , ilʹâ , илья , ilja , ілья , i̇lya , ilià , илия
αζίζ => сауд , səud , азіз , ազիզ , азиз , սաուդ , azíz , azīz , saüd , aziz , саўд , saʿūd , саӏуд , saud
αμίν => أمين , amīn , əmin , امین , amín , амин , آمين , amin , ամին , امين , амін
ανρί => anrī , анрі , анри , انری , анры , هنري , هنری , آنری , anri , անրի , הנרי , هنرى
αντόνιο => άντονι , antônio , antonio , antoni , antónio , antòni
εμίλ => اميل , эмил , أميل , エミール , إميل , エーミル , ემილ , امیل , emil , אמיל , עמיל , έμιλ , էմիլ , емил
ερίκ => erik , اريك , érïk , ерик , έρικ , эрик , اریک , エリック , אריק , أريك , ерік , էրիկ , إريك
ζοάο => joão , žoao , ժոաո , joao , joäo , joáo , жоао
ζοζέ => jose , ժոզե , josè , josé , žoze , жозе , žozē
ζορζ => ժորժ , ζωρζ , žorž , жорж , جورج , ƶorƶ
ζωρζ => ժորժ , žorž , жорж , ζορζ , جورج , ƶorƶ
ιβάν => իվան , ივან , іван , иван
ιλία => iliá , ιλιά , ilia , ilʹâ , илья , ілья , ίλια , ilià , илия
ιλιά => iliá , ilya , илја , ilia , ιλία , իլյա , iļja , iljá , iľja , ilʹâ , илья , ilja , ίλια , i̇lya , ілья , ilià , илия
καρλ => отто , كارل , オットー , karl , carl , կարլ , карл , קארל , կառլ , კარლ , otto , کارل
κοέν => koen , κόεν , کوهن , коен , كوهن , коэн
κρις => крис , kris , کریس , крыс , כריס , كريس , кріс
κόεν => κοέν , koen , کوهن , коен , كوهن , коэн
λέον => león , լեոն , لیون , леон , léon , λεόν , leon , لئون , ليون , λέων
λέων => папа , león , pàpa , լեոն , لیون , леон , papa , léon , pápa , λεόν , leon , لئون , ليون , λέον
λίαμ => ліям , лиам , լիամ , ліам , liam , ليام , لیام
λίζα => лиса , liza , lisa , ლიზა , ліза , լիզա , лиза , ليزا , līsa , līza , لیزا
λίλα => ᕤᐒᓄᔅ , ლილა , ܕܘܢܤ , lila , ліля , ліла , ዶወንሡ , ዾውንስ , ܠܝܠܐ , լիլա , ዳውንስ , лила
λεόν => león , լեոն , لیون , леон , léon , leon , لئون , ليون , λέων , λέον
λόρι => lori , лори , لوري , лорі , לורי , لوری
μάρκ => מארק , marc , مارك , μαρκ , მარკ , mark , марк , مارک , մարկ
μέρι => meri , ماری , мэри , მერი , մերի , mary , мери , メアリー , мері , مارى , ماري
μίκι => miki , միկի , мікі , میکی , мики , ميكي
μαρί => մարի , ماری , mari , mary , марі , ماري , мари , мары , مارى
μαρία => マリーア , maría , maria , марія , anna , mária , анна , άννα , мария
μαρκ => מארק , marc , մարկ , مارك , mark , марк , مارک , μάρκ
νίνο => نینو , نينو , נינו , ніно , նինո , nino , нино , niño
νοέλ => noel , نويل , noèl , նոել , ноел , ноэл , νόελ , نوئل , noël , nöel
νόελ => νοέλ , noel , نويل , noèl , նոել , ноел , ноэл , نوئل , noël , nöel
ομάρ => ʿumar , ömər , omar , umar , უმარ , ӏумар , omár , ʿomar , úmar , умар , омар
πασά => паша , paša , pașa , pasa , باشا , paşa
πιέρ => пиер , پیئر , πιερ , pier , پییر , пьер , պիեռ , פייר , ピエール , պիեր
πιερ => пиер , پیئر , pier , πιέρ , پییر , пьер , պիեռ , פייר , ピエール , պիեր
ρίκι => рікі , ریکی , рики , ريكي , ռիկի , riki
ρίτα => ریتا , ріта , ريتا , ռիտա , рыта , рита , rita
σάρα => սարա , сара , sara , سارة , սառա , sára , سارا
σάρλ => շառլ , шарл , შარლ , שארל , շարլ , σαρλ , シャルル , şarl , šarl , شارل
σαρλ => շառլ , шарл , შარლ , שארל , շարլ , シャルル , şarl , šarl , σάρλ , شارل
τζον => john , τζόν , τζων , джон
τζων => джон , john , τζόν , τζον
τζόν => john , джон , τζων , τζον
τόνι => توني , טוני , تونى , тоні , تونی , toni , тони , طوني , tony
χανς => ჰანს , ханс , هانس , հանս
όττο => отто , օտտօ , اوتو , ottó , օտտո , أوتو , otto
азиз => сауд , səud , азіз , ազիզ , αζίζ , عزیز , عزيز , սաուդ , azíz , azīz , saüd , aziz , саўд , saʿūd , саӏуд , saud
азіз => сауд , səud , ազիզ , αζίζ , عزیز , азиз , սաուդ , azíz , عزيز , azīz , saüd , aziz , саўд , saʿūd , саӏуд , saud
александар => aleksandar , aleksandr , алеқсандр , александр
александер => aleksándr , aleksandr , aleksander , александр
александр => александер , oleksandr , олександр , аляксандр , aleksander , алеқсандр , александар , александрович , aleksándr , aleksandrovič , aleksandar , александър , аляксандар , aleksandr , ołeksandr , алєксандр
александрович => александр , олександрович , aleksandrovič , aleksandr , aлeксандрович , аляксандравіч
александър => александр
алексеевич => олексійович
алексей => oleksij , алексеј , aleksej , олексій , ołeksij
алексеј => oleksij , алексей , aleksej , олексій , ołeksij
алеқсандр => аляксандр , александар , александр , aleksandar , aleksandr
аляксандар => alaksandar , alaksandr , аляксандр , александр
аляксандр => олександр , alaksandr , алеқсандр , александр , аляксандар , alaksandar
аляксандравіч => александрович , aлeксандрович
алєксандр => oleksandr , олександр , александр , aleksandr , ołeksandr
амин => أمين , amīn , αμίν , əmin , امین , amín , آمين , amin , ամին , امين , амін
амир => أمير , amir , амір , əmir , әмир , امير , ամիր , امیر , amír
амін => أمين , amīn , αμίν , əmin , امین , amín , амин , آمين , amin , ամին , امين
амір => أمير , amir , امير , əmir , әмир , ամիր , امیر , amír , амир
анатоли => анатолій , anatoli , anatolij , анатолий
анатолий => анатолій , anatoli , anatolij , анатоли
анатольевич => анатолійович , анатольевіч
анатольевіч => анатолійович , анатольевич
анатолій => анатоли , anatoli , anatolij , анатолий
анатолійович => анатольевіч , анатольевич
анди => andy , أندي , անդի , アンディ , анді , اندی
андреевич => андрійович , андрэевіч
андрей => андрій , андреј , андрэй , andrej , andrij
андреј => андрій , андрей , андрэй , andrej , andrij
андрэевіч => андреевич , андрійович
андрэй => андрій , андреј , андрей , andrej , andrij
андрій => андреј , андрей , андрэй , andrej , andrij
андрійович => андреевич , андрэевіч
анді => andy , أندي , անդի , анди , アンディ , اندی
анна => マリーア , աննա , maría , maria , աննե , anne , марія , anna , mária , μαρία , άννα , мария
анри => anrī , ανρί , анрі , انری , анры , هنري , هنری , آنری , anri , անրի , הנרי , هنرى
анры => ανρί , анрі , анри , انری , آنری , անրի , anri , anrī
анрі => anrī , ανρί , анри , انری , анры , هنري , هنری , آنری , anri , անրի , הנרי , هنرى
антон => anton , антонио , antônio , antón , antonio , antónio
антонио => anton , antônio , antón , antonio , antónio , антон
ахмад => aḥmad , aḥmed , ahmad , ʿahmed , ахмед , àhmad , ahmed
ахмед => aḥmad , aḥmed , ahmad , ʿahmed , àhmad , ahmed , ахмад
барон => лорд , baron , lord , barón
бернард => bernhard , bernard , бернхард
бернхард => бернард , bernhard , bernard
борбон => borbón , borbon , burbon , бурбон
брус => brus , بروس , ბრუს , brüs , ברוס , брюс , ブルース
брюс => brus , بروس , ბრუს , brüs , ברוס , ブルース , брус
бурбон => borbón , борбон , borbon , burbon
валери => валерий , valerij , valeri , валерій , валериј
валерий => valerij , валери , valeri , валерій , валериј
валериј => валерий , valerij , валери , valeri , валерій
валерій => валерий , valerij , валери , valeri , валериј
василий => василиј , василь , васіль
василиј => василь , василий , васіль
василь => василиј , василий , васіль
васильевич => васильович
васильович => васильевич
васіль => василиј , василь , василий
вера => فيرا , věra , վերա , فیرا , vera
вилхелм => вильгельм , vilhelm , вільгельм , vilʹgelʹm
вильгельм => vilhelm , вільгельм , вилхелм , vilʹgelʹm
вильям => ўільям , уільям , вільям , уильям
владимир => владимирович , volodímir , vladimír , vladimir , vladimírovič , уладзімір , володимир , владімір , vladimirovič , ŭładzimir , уладзимир , volodimir , vladímir
владимирович => владимир , vladimír , vladimir , vladimírovič , володимирович , vladimirovič
владімір => владимир , volodímir , vladimir , володимир , volodimir , vladímir
володимир => владимир , volodímir , vladimir , владімір , volodimir , vladímir
володимирович => владимирович
вільгельм => вильгельм , vilhelm , вилхелм , vilʹgelʹm
вільям => уільям , ўільям , вильям , уильям
ганс => ჰანს , هانس , hans , հանս , ханс , gans
гари => غاري , gari , გარი , гары , գարի , gary , гарі
гары => غاري , гари , გარი , գարի , gary , ゲイリー , гарі
гарі => غاري , gari , гари , გარი , гары , գարի , gary
генрих => хайнріх , генріх , хайнрих , хајнрих
генріх => хайнріх , хайнрих , генрих , хајнрих
георг => george , георге , георгэ , karl , карл , ґеорґе , georg
георге => george , георгэ , ґеорґе , georg , георг
георги => георгі , georgij , георгій , георгиј , георгий , georgi
георгий => георги , георгі , georgij , георгій , георгиј , georgi
георгиј => георги , георгі , georgij , георгій , георгий , georgi
георгэ => george , георге , ґеорґе , georg , георг
георгі => георги , georgij , георгій , георгиј , георгий , georgi
георгій => георги , георгі , georgij , георгиј , георгий , georgi
гери => гэри , гері , ґері , գերի , გერი , ゲーリー , gary
гері => гэри , ґері , гери , գերի , გერი , ゲーリー , gary
граф => earl
грег => غريغ , գրեգ , グレッグ , грэг , greg
грей => ґрей , грэй , grây , grej , греј , gray
греј => грей , ґрей , грэй , grây , grej , gray
григорович => григорьевич
григорьевич => григорович
грин => грын , грін , גרין , گرین , غرين , գրին , ґрін
грын => грін , грин , גרין , گرین , գրին , ґрін
грэг => غريغ , գրեգ , грег , グレッグ , greg
грэй => грей , ґрей , grây , grej , греј , gray
грін => грын , грин , גרין , گرین , غرين , գրին , ґрін
гуго => гуґо , гюґо , hugo , гюго
гуґо => гюґо , hugo , гуго , гюго
гэри => гері , ґері , гери , գերի , გერი , ゲーリー , gary
гюго => гуґо , гюґо , hugo , гуго
гюґо => гуґо , гюго , hugo , гуго
давид => дэвид , devid , девід , david , давід , девид
давід => давид , дэвид , devid , девід , david , девид
даниел => данієль , даниэль , даніель , даниель , даніэль , даниэл , даніел
даниель => данієль , даниэль , даніель , даніэль , даниэл , даниел , даніел
даниэл => данієль , даниэль , даніель , даниель , даніэль , даниел , даніел
даниэль => данієль , даніель , даниель , даніэль , даниэл , даниел , даніел
даніел => данієль , даниэль , даніель , даниель , даніэль , даниэл , даниел
даніель => данієль , даниэль , даніэль , даниель , даниэл , даниел , даніел
даніэль => данієль , даниэль , даніель , даниель , даниэл , даниел , даніел
данієль => даниэль , даніель , даниель , даніэль , даниэл , даниел , даніел
девид => дэвід , давид , дэвид , devid , дэйвід , девід , david , дейвид , давід , дејвид
девід => дэвід , давид , дэвид , devid , дэйвід , david , дейвид , давід , девид , дејвид
дейв => dave , дэйв
дейвид => дэвід , дэвид , дэйвід , девід , девид , дејвид
дејвид => дэвід , дэвид , дэйвід , девід , дейвид , девид
джек => ジャック , džek , jack , джэк
джон => john , τζόν , τζων , τζον
джэк => ジャック , džek , jack , джек
диаз => դիաս , dïas , دیاز , diáz , diaz , díaz , დიას , діаз , диас , دياز , діас
диас => դիաս , dïas , دیاز , диаш , diáz , диаз , diaz , diaš , díaz , დიას , діаз , діаш , دياز , dias , діас
диаш => دیاز , diaš , діаш , диас , دياز , dias , діас
дирк => дырк , դիրկ , dirk , ديرك , дірк , دیرک
дмитри => dmitri , dmitrij , дмитрий , dmitríj
дмитриj => дмитриј , дмитрий , дмитро
дмитриевич => dmitrovič , дмитрович , dmitrievič , dmitrievic
дмитрий => дмитриј , дмитриj , dmitri , дмитри , dmitríj , dmitrij , дмитро
дмитриј => дмитриj , дмитрий , дмитро
дмитро => дмитриј , дмитриj , дмитрий
дмитрович => dmitrovič , дмитриевич , dmitrievič , dmitrievic
дырк => դիրկ , dirk , ديرك , дирк , дірк , دیرک
дэвид => дэвід , давид , devid , девід , дэйвід , david , дейвид , давід , девид , дејвид
дэвід => дэвид , дэйвід , девід , дейвид , девид , дејвид
дэйв => dave , дейв
дэйвід => дэвід , дэвид , девід , дейвид , девид , дејвид
діаз => դիաս , dïas , دیاز , diáz , диаз , diaz , díaz , დიას , диас , دياز , діас
діас => դիաս , dïas , دیاز , диаш , diáz , diaz , diaš , díaz , დიას , діаз , діаш , диас , دياز , dias , диаз
діаш => دیاز , диаш , diaš , диас , دياز , dias , діас
дірк => дырк , դիրկ , dirk , ديرك , дирк , دیرک
евгений => євген , евгениј
евгениј => евгений , євген
едвард => едуард , эдвард , эдўард , эдуард
едуард => էդուարդ , эдвард , էդվարդ , eduard , eduárd , эдуард , едвард , edvard , эдўард
екатерина => јекатерина , ekaterina , jekatěrina , jekaterina
елена => јелена , elena , ołena , єлена , olena , олена , jeļena , jelena
еліс => эліс , أليس , элис , الیس , էլիս , إليس , آلیس
емил => اميل , эмил , أميل , エミール , إميل , エーミル , ემილ , εμίλ , امیل , emil , אמיל , עמיל , έμιλ , էմիլ
емма => emma , эмма , إيما , էմմա , έμμα
енді => آندي , andy , أندي , энди , էնդի , اندی
ерик => erik , اريك , érïk , אריק , eric , έρικ , эрик , ερίκ , اریک , エリック , éric , أريك , ерік , էրիկ , إريك
ернест => ернст , ernest , эрнест , эрнст , ernst
ернст => ernest , ернест , эрнест , эрнст , ernst
ерік => erik , اريك , érïk , אריק , ерик , eric , έρικ , эрик , ερίκ , اریک , エリック , éric , أريك , էրիկ , إريك
ешли => էշլի , эшли , ешлі , eşli , آشلي , أشلى , ešli , اشلی , эшлі , اشلي , أشلي
ешлі => էշլի , ешли , эшли , eşli , آشلي , أشلى , ešli , اشلی , эшлі , اشلي , أشلي
жоао => joão , žoao , ժոաո , joao , ζοάο , joäo , joáo
жозе => jose , josé , josè , ζοζέ , ժոզե , žoze , žozē
жорж => ժորժ , ζωρζ , žorž , ζορζ , جورج , ƶorƶ
жуан => joão , joâo , joao , zuan , joäo , joáo , joāo
ивaн => ívan , îvan , iван , иван , イヴァン , іван , ივან , ïvan , iván , իվան , ivan
иван => ívan , iван , イヴァン , իվան , йоһан , ივან , joan , איבן , ιβάν , іванович , ivanovič , îvan , ивaн , ïvan , йоан , ivan , іван , ïvanovïç , i̇van , iwan , иванович , iván , ivanovic , îwan
иванович => іван , иван , іванавіч , ivanovič , ïvan , ivanovic , ivan , іванович , ïvanovïç
игор => იგორ , イゴーリ , ígor , իգոր , igor , igorʹ , イーゴリ , игорь , ігор
игорь => игор , igorʹ , igor , ігор
илия => iliá , ilya , ιλιά , ilia , ιλία , իլյա , ilʹâ , илья , ілья , ίλια , i̇lya , ilià
илья => iliá , ιλιά , илја , ilya , ilia , ιλία , ίλια , iļja , iljá , iľja , ilʹâ , ilja , ілья , ilià , илия
илја => iliá , ilya , i̇lyä , ιλιά , ilia , ίλια , իլյա , iļja , iljá , iľja , илья , ilʹâ , ilja , ілья , i̇lya , ilià
иоанн => йован , i̇oann , іоанн , ioann , јован , jovan
иоганн => јохан , йохан
иржи => jiří , jiri , іржі , іржи , jirí , իրժի , їржі , jiři
йоан => joão , йоһан , joâo , joāo , иван , ジョアン , jóhann , joao , johann , jean , joäo , ジョアオ , joáo , joan , ivan , йоханн
йован => иоанн , i̇oann , іоанн , ioann , јован , jovan
йоел => joël , جويل , جوئل , ջոել , جویل , joel
йохан => јохан , johan , jóhann , johann , иоганн , йоханн
йоханн => johan , jóhann , йохан , johann , йоан , joan
йоһан => йоан , joan , иван , ivan
карел => karel , karl , карл
карл => отто , карол , كارل , карел , karel , karol , オットー , karl , georg , carl , կարլ , георг , קארל , կառլ , კარლ , καρλ , otto , کارل
карол => karol , karl , карл
като => kató , کاتو , kato , katō , كاتو
кейт => кэйт , kejt , кејт , kate
кент => كينت , کینت , kent
кери => кэри , كارى , кері , كاري , keri
кері => кэри , كارى , кери , كاري , keri
кејт => кэйт , кейт , kejt , kate
кинг => کینگ , كينغ , кінг , king
кирк => كيرك , kirk , кірк , կիրկ
клод => كلود , klod , کلود , クロード , կլոդ
коен => κοέν , koen , κόεν , کوهن , كوهن , коэн
константин => констянтин , костянтин , костантин , конштантін
констянтин => костянтин , костантин , константин , конштантін
конштантін => констянтин , костянтин , костантин , константин
костантин => констянтин , костянтин , константин , конштантін
костянтин => констянтин , костантин , константин , конштантін
коэн => κοέν , koen , κόεν , کوهن , коен , كوهن
крис => kris , крыс , کریس , כריס , كريس , кріс , κρις
кристиан => христиан , крістіан , христіян , хрістіан , кристиян , кристіан , христіан , хрістіян , християн
кристиян => христиан , крістіан , христіян , хрістіан , кристіан , христіан , хрістіян , кристиан , християн
кристіан => христиан , крістіан , христіян , хрістіан , кристиян , христіан , хрістіян , кристиан , християн
крыс => крис , kris , کریس , כריס , كريس , кріс , κρις
кріс => крис , kris , کریس , крыс , כריס , كريس , κρις
крістіан => христиан , христіян , хрістіан , кристиян , кристіан , христіан , хрістіян , кристиан , християн
курт => kurt , كورت , کورت
кэйт => kejt , кейт , кејт , kate
кэри => كارى , кери , кері , كاري , keri
кінг => кинг , كينغ , کینگ , king
кірк => كيرك , кирк , kirk , կիրկ
ланг => لانغ , lang , լանգ , láng
леон => león , լեոն , لیون , léon , λεόν , leon , لئون , ليون , λέων , λέον
лиам => ліям , լիամ , ليام , ліам , liam , لیام , λίαμ
лиза => лиса , liza , lisa , ლიზა , ліза , լիզա , ليزا , λίζα , līsa , līza , لیزا
лила => ᕤᐒᓄᔅ , ლილა , ܕܘܢܤ , lila , ліля , ዶወንሡ , ዾውንስ , ܠܝܠܐ , լիլա , λίλα , ዳውንስ , ліла
лима => լիմա , لیما , ліма , lima , ليما
лиса => liza , lisa , ლიზა , ліза , լիզա , лиза , ليزا , λίζα , līsa , līza , لیزا
лорд => baron , барон , lord , barón
лори => lori , лорі , لوري , λόρι , לורי , لوری
лорі => lori , лори , لوري , λόρι , לורי , لوری
луíс => луїш , luiş , لویس , луис , لويس , luís , луїс , луіс , luis , луіш , lüis , луиш , люис
луиз => луїш , луис , люіс , luís , луїс , луіс , luiz , luíz , луиш
луис => луíс , луїш , luiş , لویس , jose , люіс , لويس , luís , луїс , луиз , луіс , josé , luiz , luis , луіш , lüis , luíz , луиш , люис
луиш => луíс , луїш , luiş , لویس , луис , люіс , لويس , luís , луїс , луиз , луіс , luiz , luis , луіш , lüis , luíz , люис
лука => lwka , luka , люка , lūka , لوکا , لوكا
луіс => луíс , луїш , luiş , لویس , луис , люіс , لويس , luís , луїс , луиз , luiz , luis , луіш , lüis , luíz , луиш , люис
луіш => луíс , луїш , luiş , لویس , луис , لويس , luís , луїс , луіс , luis , lüis , луиш , люис
луїс => луíс , луїш , luiş , لویس , луис , jose , люіс , لويس , luís , луиз , луіс , josé , luiz , luis , луіш , lüis , luíz , луиш , люис
луїш => луíс , luiş , لویس , луис , люіс , لويس , luís , луїс , луиз , луіс , luiz , luis , луіш , lüis , luíz , луиш , люис
люис => луíс , луїш , luiş , لویس , луис , لويس , luís , луїс , луіс , luis , луіш , lüis , луиш
люка => lwka , luka , lūka , لوکا , لوكا , лука
люіс => луїш , луис , luís , луїс , луиз , луіс , luiz , luíz , луиш
ліам => ліям , лиам , լիամ , ليام , liam , لیام , λίαμ
ліза => лиса , liza , lisa , ლიზა , լիզա , лиза , ليزا , λίζα , līsa , līza , لیزا
ліла => ᕤᐒᓄᔅ , ლილა , ܕܘܢܤ , lila , ліля , ዶወንሡ , ዾውንስ , ܠܝܠܐ , լիլա , λίλα , ዳውንስ , лила
ліля => ᕤᐒᓄᔅ , ლილა , ܕܘܢܤ , lila , ліла , ዶወንሡ , ዾውንስ , ܠܝܠܐ , լիլա , λίλα , ዳውንስ , лила
ліма => лима , լիմա , لیما , lima , ليما
ліям => лиам , լիամ , ليام , ліам , liam , لیام , λίαμ
майк => mayk , mike , مايك , մայկ , majk , مایک , мајк
макс => マックス , ماكس , maks , ماکس , მაქს
мари => մարի , ماری , mari , mary , марі , ماري , μαρί , мары , مارى
мариа => марија , maria , marija , marya , марыя , мария
марие => maría , марія , marie , mária , marìa , мария
мария => マリーア , марија , maría , maria , marija , marya , марія , anna , marie , mária , анна , μαρία , marìa , мариа , марие , άννα , марыя
марија => maría , maria , marija , марія , mária , мариа , мария
марк => מארק , marc , مارك , μαρκ , მარკ , mark , մարկ , مارک , μάρκ
мары => մարի , ماری , mari , mary , марі , ماري , μαρί , мари , مارى
марыя => мариа , marya , maria , мария
марі => մարի , ماری , mari , mary , ماري , μαρί , мари , мары , مارى
марія => マリーア , марија , maría , maria , marija , anna , marie , mária , анна , μαρία , marìa , марие , άννα , мария
мајк => mayk , mike , مايك , մայկ , majk , مایک , майк
мери => meri , ماری , мэри , მერი , մերի , mary , メアリー , μέρι , мері , مارى , ماري
мері => meri , ماری , мэри , მერი , mary , мери , メアリー , μέρι , մերի , مارى , ماري
метт => мэтт , matt
мике => mike , مايك , մայկ , міке , مایک
мики => μίκι , miki , միկի , мікі , میکی , ميكي
микола => mikola , николáй , mikoła , nikołaj , nikolaj , мікола , николај , николай
миколайович => николáeвич , николаевич
михаил => mihajlo , михайло , mihail , михајло , михаїл
михайло => mihajlo , mihail , михајло , михаил , михаїл
михайлович => михајлович , міхайлавіч
михаїл => mihajlo , михайло , mihail , михајло , михаил
михајло => mihajlo , михайло , mihail , михаил , михаїл
михајлович => міхайлавіч , михайлович
мори => موري , mōri , موری , морі , mori , մորի , מורי
морі => موري , mōri , موری , mori , մորի , мори , מורי
мохамед => мухаммед , muhàmmad , муhаммед , muhámmad , muḥammad , mohamed , muhammad , muḩammad , мохаммед , мухаммад , mohámed , мухӏаммад , muħammed , muhammed , mohammed
мохаммад => muhàmmad , muḥammad , muhammad , muḩammad , мухӏаммад , mohammad
мохаммед => мухаммед , muhàmmad , muhámmad , mohámmed , muḥammad , muhammad , mohamed , muḩammad , мохамед , мухаммад , muħammed , muhammed , mohammed
муhаммед => mohamed , мохамед , muħammed , muhammed , mohámed , мухаммед
муса => musa , mūsā , موسی , موسي , موسى
мухаммад => мухаммед , muhàmmad , muhámmad , mohámmed , мохаммед , muhammad , muḥammad , muḩammad , mohamed , мохамед , mohámed , мухӏаммад , muħammed , muhammed , mohammed
мухаммед => muhàmmad , муhаммед , мохаммед , muhammad , muħammed , muhammed , mohamed , мухаммад , мохамед , mohámed , mohammed
мухӏаммад => muhàmmad , muhámmad , mohamed , muhammad , мохамед , muḥammad , muḩammad , мухаммад , mohámed , мохаммад , mohammad
мэри => meri , ماری , მერი , մերի , mary , мери , メアリー , μέρι , мері , مارى , ماري
мэтт => matt , метт
мікалаевiч => мікалаевіч , николаевич
мікалаевіч => мікалаевiч , николаевич
мікалай => nikołaj , nikolaj , mikalaj , николај , николай , mikałaj
міке => mike , مايك , մայկ , مایک , мике
мікола => mikola , николáй , микола , mikoła , nikołaj , nikolaj , николај , николай
мікі => μίκι , miki , միկի , میکی , мики , ميكي
міхайлавіч => михајлович , михайлович
николáeвич => николај , николáй , николаевич , nikolaj , миколайович , николай , nikolaevič
николáй => mikola , микола , mikoła , nikołaj , николаевич , nikolaj , мікола , николај , николай , николáeвич , nikolaevič
николаевич => николај , николáй , мікалаевiч , мікалаевіч , nikolaj , миколайович , николай , николáeвич , nikolaevič
николай => mikola , николáй , микола , николáeвич , mikoła , nikołaj , николаевич , nikolaj , mikalaj , мікола , николај , mikałaj , мікалай , nikolaevič
николај => mikola , николáй , микола , николáeвич , mikoła , nikołaj , николаевич , nikolaj , mikalaj , мікола , николай , mikałaj , мікалай , nikolaevič
нина => نينا , նինա , ніна , nīnà , نینا , nina
нино => نینو , نينو , נינו , ніно , նինո , nino , νίνο , niño
ноел => νοέλ , noel , نويل , noèl , նոել , ноэл , νόελ , نوئل , noël , nöel
ноэл => νοέλ , noel , نويل , noèl , նոել , ноел , νόελ , نوئل , noël , nöel
ніна => نينا , нина , նինա , nīnà , نینا , nina
ніно => نینو , نينو , נינו , նինո , nino , νίνο , нино , niño
олександр => oleksandr , аляксандр , александр , aleksandr , ołeksandr , алєксандр
олександрович => александрович , aлeксандрович
олексій => oleksij , алексеј , алексей , aleksej , ołeksij
олексійович => алексеевич
олена => ołena , elena , елена , olena
омар => ʿumar , ömər , omar , umar , უმარ , ӏумар , omár , ομάρ , ʿomar , úmar , умар
отто => օտտօ , όττο , اوتو , אוטו , كارل , オットー , karl , ottó , карл , օտտո , أوتو , καρλ , otto , کارل
пëтр => petro , petr , петр , петро
павел => pavlo , павло , pavel
павло => павел , pavlo , pavel
папа => león , pave , papa , léon , pápa , pāpa , hông , pópù , สมเด , pous , pape , giáo , pope , paus , pàpa , leon , λέων , fòng
паул => paul , باول , поль
паша => پاشا , pasha , paša , պաշա , pașa , باشا , pasa , πασά , ფაშა , paşa
петĕр => pëtr , pětr , pêtr , петер , peter , petr , пётр , петр
петар => petr , petar , пётр , пётар , петр
петер => pëtr , pětr , pêtr , peter , petr , петĕр , пётр , петр
петр => петро , pëtr , pêtr , pětr , петер , петар , peter , petro , petr , пëтр , петĕр , petar , пётр , пётар
петро => pëtr , petro , petr , пëтр , пётр , петр
пиер => پیئر , πιερ , pier , πιέρ , پییر , пьер , պիեռ , פייר , ピエール , պիեր
поль => paul , паул
пьер => пиер , بییر , πιερ , pier , πιέρ , بيير , ピエール
пётар => петар , petr , petar , пётр , петр
пётр => петро , pëtr , pětr , pêtr , петер , петар , peter , petro , petr , петĕр , petar , пётар , петр
райс => رايس , рајс , ռայս , rajs , rays , رایس , رائس
райт => رایت , رايت , рајт
рајс => رايس , ռայս , rajs , rays , رایس , райс , رائس
рајт => رایت , رايت , райт
рики => рікі , ریکی , ريكي , ռիկի , riki , ρίκι
рита => ریتا , ріта , ريتا , ռիտա , рыта , rita , ρίτα
росе => rouz , роўз , rose , როუზ , роуз , rosé
роуз => rouz , роўз , rose , როუზ , rosé , росе
роўз => rouz , როუზ , rose , роуз , rosé , росе
рыта => ریتا , ріта , ريتا , ռիտա , рита , rita , ρίτα
рікі => ریکی , рики , ريكي , ռիկի , riki , ρίκι
ріта => ریتا , ريتا , ռիտա , рыта , рита , rita , ρίτα
саид => səid , saïd , սաիդ , said , саід , saíd , سعيد , سعید , саїд , سەید
сара => սարա , sara , سارة , սառա , sára , سارا , σάρα
сато => satō , sato , sató , satô , ساتو
сауд => səud , азіз , ազիզ , αζίζ , азиз , սաուդ , azíz , azīz , saüd , aziz , саўд , saʿūd , саӏуд , saud
саід => səid , saïd , սաիդ , said , سعيد , saíd , سعید , саїд , саид , سەید
саїд => səid , saïd , սաիդ , said , саід , saíd , سعيد , سعید , саид , سەید
саўд => сауд , səud , азіз , ազիզ , αζίζ , азиз , սաուդ , azíz , azīz , saüd , aziz , saʿūd , саӏуд , saud
саӏуд => сауд , səud , азіз , ազիզ , αζίζ , азиз , սաուդ , azíz , azīz , saüd , aziz , саўд , saʿūd , saud
свен => sven , سفين , սվեն
сергеевич => сергійович
сергей => сяргей , сергеј , сергий , сергій
сергеј => сяргей , сергий , сергей , сергій
сергий => сергеј , сергей , сергій
сергій => сергеј , сергей , сергий
сергійович => сергеевич
смит => سميث , سمیت , сміт , سمیث , سميت , smit , סמית
сміт => смит , سميث , سمیت , سمیث , سميت , smit , סמית
софи => سوفی , софі , софӣ , صوفي , սոֆի , سوفي
софі => سوفی , софӣ , софи , صوفي , սոֆի , سوفي
софӣ => سوفی , софі , софи , صوفي , սոֆի , سوفي
стив => ستيف , სთივ , ստիվ , stiv , սթիվ , სტივ , סטיב , стів
стів => ستيف , სთივ , ստիվ , стив , stiv , սթիվ , სტივ , סטיב
сяргей => сергеј , сергей
тони => توني , טוני , تونی , тоні , τόνι , تونى , toni , طوني , tony
тоні => توني , טוני , تونى , τόνι , تونی , toni , тони , طوني , tony
уайт => وايت , ўайт , وایت
уильям => уільям , ўільям , вильям , вільям
уладзимир => vladimir , уладзімір , ŭładzimir , владимир
уладзімір => vladimir , ŭładzimir , владимир , уладзимир
умар => ʿumar , ömər , umar , უმარ , ӏумар , omár , ομάρ , ʿomar , úmar , omar , омар
уорд => ward
уільям => ўільям , вильям , вільям , уильям
федір => фёдор , fedor , fedir
филип => філіп , філіпп , филипп
филипп => филип , філіп , філіпп
фокс => فوکس , foks , فوكس
форд => ford , فورد , ֆորդ
франсоа => fransuā , fransoa , франсуа , fransua
франсуа => fransuā , fransoa , франсоа , fransua
фред => фрэд , ֆրեդ , フレッド , fred
фредерик => fredrik , frederik , фредрик
фредрик => фредерик , fredrik , frederik
фрэд => ֆրեդ , フレッド , фред , fred
фёдор => федір , fedir , fedor
філіп => филип , філіпп , филипп
філіпп => филип , філіп , филипп
хаим => حییم , хаїм , haïm , хаім , haim , háim , חיים , حييم
хайнрих => хайнріх , генріх , генрих , хајнрих
хайнріх => генріх , хайнрих , генрих , хајнрих
ханс => ჰანს , هانس , hans , հանս , gans , هانز , χανς , ганс
хант => հանտ , hunt , هانت
хаім => حییم , хаїм , haïm , háim , haim , חיים , حييم , хаим
хаїм => حییم , haïm , хаім , haim , háim , חיים , حييم , хаим
хајнрих => хайнріх , генріх , хайнрих , генрих
херман => hermann , херманн , herman
херманн => херман , hermann , herman
хозе => jose , josé , josè
холл => hall
холт => هولت , holt
хорн => הורן , հորն , هورن , horn
хосе => خوزه , jose , hosē , josé , josè , hose , โฮเซ
христиан => христіян , крістіан , хрістіан , кристиян , кристіан , христіан , хрістіян , кристиан , християн
християн => христиан , крістіан , христіян , хрістіан , кристиян , кристіан , христіан , хрістіян , кристиан
христіан => христиан , крістіан , христіян , хрістіан , кристиян , кристіан , хрістіян , кристиан , християн
христіян => христиан , крістіан , хрістіан , кристиян , кристіан , христіан , хрістіян , кристиан , християн
хрістіан => христиан , крістіан , христіян , кристиян , кристіан , христіан , хрістіян , кристиан , християн
хрістіян => христиан , крістіан , христіян , хрістіан , кристиян , кристіан , христіан , кристиан , християн
хуан => huan , jose , juan , خوآن , josé , خوان
хуго => хюго , هوغو , hugo
хюго => هوغو , hugo , хуго
чень => чэнь , çénʹ , chen , chén
чэнь => chen , çénʹ , chén , чень
шарл => շառլ , შარლ , שארל , շարլ , σαρλ , シャルル , şarl , šarl , σάρλ , شارل
шмид => шмід , شميد , šmid
шмід => شميد , šmid , шмид
эдвард => едуард , էդուարդ , էդվարդ , eduard , eduárd , эдуард , едвард , edvard , эдўард
эдуард => едвард , едуард , эдвард , эдўард
эдўард => едвард , едуард , эдвард , эдуард
элис => эліс , أليس , الیس , էլիս , еліс , إليس , آلیس
эліс => أليس , элис , الیس , էլիս , еліс , إليس , آلیس
эмил => اميل , أميل , エミール , إميل , エーミル , ემილ , εμίλ , امیل , emil , אמיל , עמיל , έμιλ , էմիլ , емил
эмма => emma , إيما , էմմա , емма , έμμα
энди => енді , آندي , andy , أندي , էնդի , اندی
эрик => erik , اريك , érïk , אריק , ерик , eric , έρικ , ερίκ , اریک , エリック , éric , أريك , ерік , էրիկ , إريك
эрнест => ернст , ernest , ернест , эрнст , ernst
эрнст => ернст , ernest , ернест , эрнест , ernst
эшли => էշլի , ешли , ешлі , eşli , آشلي , أشلى , ešli , اشلی , эшлі , اشلي , أشلي
эшлі => էշլի , ешли , эшли , ешлі , eşli , آشلي , أشلى , ešli , اشلی , اشلي , أشلي
юрий => yuri , יורי , yury , يوري , jüri , ûrij , یوری , юрій , juri
юрій => yuri , יורי , юрий , yury , يوري , jüri , ûrij , یوری , juri
якович => яковлевич
яковлевич => якович
євген => евгений , евгениј
єлена => јелена , elena , елена , jeļena , jelena
іван => ívan , iван , イヴァン , իվան , ივან , איבן , ιβάν , іванович , ivanovič , îvan , иван , ивaн , ïvan , ivan , ïvanovïç , i̇van , iwan , иванович , iván , ivanovic , îwan
іванавіч => иванович
іванович => іван , иван , ivanovič , ïvan , иванович , ivanovic , ivan , ïvanovïç
ігор => იგორ , игор , イゴーリ , ígor , իգոր , igor , イーゴリ , игорь
ілья => iliá , ιλιά , илја , ilya , ilia , ιλία , iļja , iljá , iľja , илья , ilʹâ , ilja , ίλια , ilià , илия
іоанн => йован , иоанн , i̇oann , ioann , јован , jovan
іржи => jiří , jiri , іржі , jirí , иржи , իրժի , їржі , jiři
іржі => jiří , jiri , іржи , jirí , иржи , իրժի , їржі , jiři
їржі => jiří , jiri , іржі , іржи , jirí , иржи , իրժի , jiři
јекатерина => екатерина , ekaterina , jekatěrina , jekaterina
јелена => elena , елена , єлена , jeļena , jelena
јован => йован , иоанн , i̇oann , іоанн , ioann , jovan
јохан => йохан , иоганн
јуан => john , joão , joao , juan , jean
јури => yuri , יורי , يوري , ユーリー , یوری , juri
ўайт => وايت , уайт , وایت
ўільям => уільям , вильям , вільям , уильям
ґеорґе => george , георге , георгэ , georg , георг
ґері => гэри , гері , гери , գերի , გერი , ゲーリー , gary
ґрей => грей , грэй , grây , grej , греј , gray
ґрін => грын , грін , грин , גרין , گرین , غرين , գրին
ӏумар => ʿumar , ömər , omar , umar , უმარ , omár , ομάρ , ʿomar , úmar , умар , омар
әмир => أمير , amir , амір , əmir , امير , ամիր , امیر , amír , амир
ազիզ => сауд , səud , азіз , عزیز , αζίζ , азиз , սաուդ , azíz , عزيز , azīz , saüd , aziz , саўд , saʿūd , саӏуд , saud
ամին => أمين , amīn , αμίν , əmin , امین , amín , амин , آمين , amin , امين , амін
ամիր => أمير , amir , амір , əmir , әмир , امير , امیر , amír , амир
այան => ایان , حرصي , أيان , هرسی , هرسي , حرسي , ايان , حرصی , ayan , آیان , حرسی , آيان
անդի => andy , أندي , анди , アンディ , анді , اندی
աննա => anne , анна , άννα
աննե => anne , анна , anna
անրի => anrī , ανρί , анрі , анри , انری , анры , هنري , هنری , آنری , anri , הנרי , هنرى
գարի => غاري , gari , гари , გარი , гары , gary , гарі
գերի => гэри , гері , ґері , гери , გერი , ゲーリー , gary
գրեգ => غريغ , грег , грэг , グレッグ , greg
գրին => грын , грін , грин , גרין , گرین , غرين , ґрін
դիաս => dïas , diáz , диаз , diaz , დიას , díaz , діаз , диас , діас
դիրկ => дырк , dirk , ديرك , дирк , дірк , دیرک
էդուարդ => едуард , էդվարդ , эдвард , eduárd , edvard , eduard
էդվարդ => едуард , էդուարդ , эдвард , eduárd , edvard , eduard
էլիս => эліс , أليس , элис , الیس , еліс , إليس , آلیس
էմիլ => اميل , эмил , أميل , エミール , إميل , エーミル , ემილ , εμίλ , امیل , emil , אמיל , עמיל , έμιλ , емил
էմմա => emma , эмма , إيما , емма , έμμα
էնդի => енді , آندي , andy , أندي , энди , اندی
էշլի => ешли , эшли , ешлі , eşli , آشلي , أشلى , ešli , اشلی , эшлі , اشلي , أشلي
էրիկ => erik , اريك , érïk , אריק , ерик , eric , έρικ , эрик , ερίκ , اریک , エリック , éric , أريك , ерік , إريك
ժոաո => joão , žoao , joao , ζοάο , joäo , joáo , жоао
ժոզե => jose , josé , josè , ζοζέ , žoze , жозе , žozē
ժորժ => ζωρζ , žorž , жорж , ζορζ , جورج , ƶorƶ
իգոր => იგორ , игор , イゴーリ , ígor , igor , イーゴリ , ігор
իլյա => iliá , i̇lyä , ilya , илја , ιλιά , ilia , iļja , iljá , iľja , ilja , ίλια , i̇lya , ilià , илия
իվան => ívan , îvan , iван , иван , i̇van , イヴァン , ивaн , iwan , ივან , ïvan , איבן , ivan , iván , ιβάν , іван , îwan
իրժի => jiří , jiri , іржі , іржи , jirí , иржи , їржі , jiři
լանգ => ланг , لانغ , lang , láng
լեոն => león , لیون , леон , léon , λεόν , leon , لئون , ليون , λέων , λέον
լիամ => ліям , лиам , liam , ليام , ліам , لیام , λίαμ
լիզա => лиса , liza , lisa , ლიზა , ліза , лиза , ليزا , λίζα , līsa , līza , لیزا
լիլա => ᕤᐒᓄᔅ , ლილა , ܕܘܢܤ , lila , ліля , ліла , ዶወንሡ , ዾውንስ , ܠܝܠܐ , λίλα , ዳውንስ , лила
լիմա => лима , لیما , ліма , lima , ليما
խոսե => jose , xose , xosé , josé , josè
կայլ => كايل , kyle , کایل
կառլ => كارل , karl , carl , կարլ , карл , קארל , კარლ , καρλ , کارل
կարլ => كارل , karl , carl , карл , קארל , կառլ , კარლ , καρλ , کارل
կիրկ => كيرك , кирк , кірк , kirk
կլոդ => клод , klod , کلود , クロード , كلود
կոջի => کوجی , kōji , koji , كوجي , kôji
հանս => ჰანს , هانس , hans , ханс , gans , هانز , χανς , ганс
հանտ => хант , hunt , هانت
հորն => хорн , הורן , هورن , horn
մայկ => mike , mayk , مايك , міке , majk , مایک , мике , майк , мајк
մարի => ماری , mari , mary , марі , ماري , μαρί , мари , мары , مارى
մարկ => מארק , marc , مارك , μαρκ , მარკ , mark , марк , مارک , μάρκ
մերի => meri , ماری , мэри , მერი , mary , мери , メアリー , μέρι , мері , مارى , ماري
միկի => μίκι , miki , мікі , میکی , мики , ميكي
մորի => موري , mōri , موری , морі , mori , мори , מורי
նինա => نينا , нина , ніна , nīnà , نینا , nina
նինո => نینو , نينو , נינו , ніно , nino , νίνο , нино , niño
նոել => νοέλ , noel , نويل , noèl , ноел , ноэл , νόελ , نوئل , noël , nöel
շառլ => шарл , შარლ , שארל , շարլ , σαρλ , シャルル , şarl , šarl , σάρλ , شارل
շարլ => շառլ , шарл , שארל , σαρλ , シャルル , şarl , šarl , σάρλ
պաշա => پاشا , паша , pasha , paša , pașa , pasa , ფაშა , paşa
պիեռ => пиер , پیئر , πιερ , pier , πιέρ , پییر , פייר , ピエール , պիեր
պիեր => пиер , πιερ , pier , πιέρ , պիեռ , ピエール
ջոան => joan , جوان , جوآن
ջոել => joël , جويل , جوئل , جویل , joel , йоел
ջորջ => ジョージ , ჯორჯ , jorj
ռայս => رايس , рајс , rajs , rice , rays , رایس , райс , رائس
ռիկի => рікі , ریکی , рики , ريكي , riki , ρίκι
ռիտա => ریتا , ріта , ريتا , рыта , рита , rita , ρίτα
սաիդ => səid , saïd , said , سعيد , саід , saíd , سعید , саїд , саид , سەید
սաուդ => сауд , səud , азіз , ազիզ , αζίζ , азиз , azíz , azīz , saüd , aziz , саўд , saʿūd , саӏуд , saud
սառա => սարա , сара , sara , سارة , sára , سارا , σάρα
սարա => сара , sara , սառա , سارة , sára , سارا , σάρα
սթիվ => სთივ , ստիվ , стив , stiv , სტივ , стів
սոֆի => سوفی , софі , софӣ , софи , صوفي , سوفي
սվեն => свен , sven , سفين
ստիվ => ستيف , სთივ , стив , stiv , սթիվ , სტივ , סטיב , стів
վերա => فيرا , вера , věra , فیرا , vera
օտտո => отто , օտտօ , όττο , اوتو , אוטו , ottó , أوتو , otto
օտտօ => отто , όττο , اوتو , ottó , օտտո , أوتو , otto
ֆորդ => ford , فورد , форд
ֆրեդ => фрэд , フレッド , фред , fred
אוטו => отто , օտտո , ottó , otto
אחמד => أحمد , احمد
איבן => ívan , îvan , іван , иван , iván , իվան , ivan
אמיל => эмил , εμίλ , emil , עמיל , έμιλ , էմիլ , емил
אריק => erik , érïk , اريك , ерик , έρικ , эрик , ερίκ , اریک , أريك , ерік , էրիկ , إريك
בויד => بوید , بويد , boyd
ברוס => brus , بروس , brüs , брюс , ブルース , брус
גרין => грын , грін , грин , گرین , գրին , ґрін
דוכס => duke
הורן => хорн , հորն , هورن , horn
הנרי => anrī , ανρί , анрі , анри , ヘンリー , هنري , هنری , անրի , anri , هنرى
חיים => حییم , хаїм , haïm , хаім , haim , háim , حييم , хаим
טוני => توني , تونى , тоні , τόνι , تونی , toni , тони , طوني , tony
יורי => yuri , юрий , يوري , یوری , юрій , juri , јури
יימס => جیمس , جیمز , جيمس
כריס => крис , kris , کریس , крыс , كريس , кріс , κρις
לורי => lori , лори , لوري , лорі , λόρι , لوری
מארק => марк , مارك , μαρκ , mark , մարկ , مارک , μάρκ
מורי => موري , mōri , موری , морі , mori , մորի , мори
מחמד => 穆罕默德 , محمد
נינו => نینو , نينو , ніно , նինո , nino , νίνο , нино , niño
סטיב => стів , stiv , ստիվ , стив
סמית => смит , سميث , سمیت , сміт , سميت , smit
עמיל => эмил , εμίλ , emil , אמיל , έμιλ , էմիլ , емил
פיטר => پیتر , پيتر , ピーター , بيتر
פייר => пиер , پیئر , πιερ , πιέρ , پییر , պիեռ
פרנק => フランク
קארל => كارل , karl , կարլ , карл , կառլ , καρλ , کارل
שארל => շառլ , шарл , շարլ , σαρλ , şarl , šarl , σάρλ
آرتور => أرثر , آرثر , ارثر , ارتور
آرثر => ارثر , آرتور , アーサー , أرثر , ارتور
آشلي => էշլի , ешли , эшли , ешлі , eşli , أشلى , ešli , اشلی , эшлі , اشلي , أشلي
آلکس => alex , الکس , àlex , ألكس , άλεξ , álex
آلیس => эліс , أليس , элис , الیس , էլիս , еліс , إليس
آمين => أمين , amīn , αμίν , əmin , امین , amín , амин , amin , ամին , امين , амін
آندي => енді , أندي , энди , էնդի , اندی
آنری => ανρί , анрі , анри , انری , анры , անրի , anri , anrī
آيان => ایان , حرصي , أيان , هرسی , هرسي , حرسي , ايان , حرصی , ayan , آیان , حرسی , այան
آیان => ایان , حرصي , أيان , այան , هرسی , هرسي , حرسي , ايان , حرصی , ayan , حرسی , آيان
أحمد => अहमद , אחמד , 艾哈迈德 , ଅହମଦ , 艾哈麥德 , ਅਹਮਦ , అహమద , അഹമദ , ಅಹಮದ , 艾哈邁德 , আহমদ , અહમદ , احمد
أرثر => آرثر , ارثر , آرتور , アーサー , ارتور
أريك => erik , اريك , אריק , ерик , eric , έρικ , эрик , ερίκ , اریک , エリック , éric , ерік , էրիկ , إريك
أشلى => էշլի , ешли , эшли , ешлі , eşli , آشلي , ešli , اشلی , эшлі , اشلي , أشلي
أشلي => էշլի , ешли , эшли , ешлі , eşli , آشلي , أشلى , ešli , اشلی , эшлі , اشلي
ألكس => alex , الکس , àlex , آلکس , άλεξ , álex
ألكسندر => الکساندر , الكساندر , الەكساندر , الېکساندر , الكسندر
أليس => эліс , элис , الیس , էլիս , еліс , إليس , آلیس
أمير => amir , امير , амір , əmir , әмир , ամիր , امیر , amír , амир
أميل => اميل , эмил , エミール , إميل , エーミル , εμίλ , امیل , emil , έμιλ , էմիլ , емил
أمين => amīn , αμίν , əmin , امین , amín , амин , آمين , amin , ամին , امين , амін
أندي => енді , آندي , andy , анди , անդի , энди , アンディ , էնդի , анді , اندی
أوتو => отто , օտտօ , όττο , اوتو , ottó , օտտո , otto
أيان => ایان , حرصي , այան , هرسی , هرسي , حرسي , ايان , حرصی , ayan , آیان , حرسی , آيان
إريك => erik , اريك , אריק , ерик , eric , έρικ , эрик , ερίκ , اریک , エリック , éric , أريك , ерік , էրիկ
إليس => эліс , أليس , элис , الیس , էլիս , еліс , آلیس
إميل => اميل , эмил , أميل , エミール , エーミル , εμίλ , امیل , emil , έμιλ , էմիլ , емил
إيرل => ایرل , ايرل , earl
إيما => emma , эмма , էմմա , емма , έμμα
احمد => अहमद , אחמד , 艾哈迈德 , ଅହମଦ , 艾哈麥德 , ਅਹਮਦ , అహమద , അഹമദ , ಅಹಮದ , 艾哈邁德 , أحمد , আহমদ , અહમદ
ارتور => آرتور , أرثر , آرثر , ارثر
ارثر => آرثر , آرتور , アーサー , أرثر , ارتور
اريك => erik , אריק , ерик , eric , έρικ , эрик , ερίκ , اریک , エリック , éric , أريك , ерік , էրիկ , إريك
اریک => erik , اريك , אריק , ерик , eric , έρικ , эрик , ερίκ , エリック , éric , أريك , ерік , էրիկ , إريك
استوارت => ستيوارت
استيو => ستيف , استیو
استیو => ستيف , استيو
استیون => ستيفن , ستیفن
اسمیت => سمیث , سميث
اسکات => سكوت , سکوت
اشلي => էշլի , ешли , эшли , ешлі , eşli , آشلي , أشلى , ešli , اشلی , эшлі , أشلي
اشلی => էշլի , ешли , эшли , ешлі , eşli , آشلي , أشلى , ešli , эшлі , اشلي , أشلي
العزيز => العزیز , عبدالعزیز , عبدالعزيز
العزیز => العزيز , عبدالعزیز , عبدالعزيز
الكساندر => الکساندر , الەكساندر , الېکساندر , ألكسندر , الكسندر
الكسندر => الکساندر , الكساندر , الەكساندر , ألكسندر , الېکساندر
الله => عبدالله
الکس => alex , àlex , ألكس , آلکس , άλεξ , álex
الکساندر => الكساندر , الەكساندر , ألكسندر , الېکساندر , الكسندر
الیس => эліс , أليس , элис , էլիս , еліс , إليس , آلیس
الېکساندر => الکساندر , الكساندر , الەكساندر , ألكسندر , الكسندر
الەكساندر => الکساندر , الكساندر , الېکساندر , ألكسندر , الكسندر
امير => أمير , amir , амір , əmir , әмир , ամիր , امیر , amír , амир
اميل => эмил , أميل , エミール , إميل , エーミル , εμίλ , امیل , emil , έμιλ , էմիլ , емил
امين => أمين , amīn , αμίν , əmin , امین , amín , амин , آمين , amin , ամին , амін
امیر => أمير , amir , амір , əmir , әмир , امير , ամիր , amír , амир
امیل => اميل , эмил , أميل , エミール , إميل , エーミル , εμίλ , emil , έμιλ , էմիլ , емил
امین => أمين , amīn , αμίν , əmin , amín , амин , آمين , amin , ամին , امين , амін
اندی => енді , آندي , andy , أندي , анди , անդի , энди , アンディ , էնդի , анді
انری => ανρί , анрі , анри , анры , آنری , անրի , anri , anrī
اوتو => отто , օտտօ , όττο , ottó , օտտո , أوتو , otto
ايان => ایان , حرصي , أيان , այան , هرسی , هرسي , حرسي , حرصی , ayan , آیان , حرسی , آيان
ايرل => ایرل , earl , إيرل
ایان => حرصي , أيان , այան , هرسی , هرسي , حرسي , ايان , حرصی , ayan , آیان , حرسی , آيان
ایرل => ايرل , earl , إيرل
باتريك => پاتریک
باشا => паша , paša , pașa , pasa , πασά , paşa
باول => paul , паул
بروس => brus , брюс , brüs , ברוס , ブルース , брус
بويد => بوید , בויד , boyd
بوید => בויד , بويد , boyd
بيتر => פיטר , پيتر , پیتەر , بیتر , ピーター , پیتر , پیتێر
بيير => пьер , بییر
بیتر => پيتر , پیتەر , بيتر , ピーター , پیتر , پیتێر
بییر => بيير , пьер
تامپسون => تومسون , طومسون
تايلور => تیلور , تيلور , تایلور
تایلور => تیلور , تيلور , تايلور
تشارلز => چارلز
تومسون => طومسون , تامپسون
تونى => توني , טוני , тоні , τόνι , تونی , toni , тони , طوني , tony
توني => טוני , تونى , тоні , τόνι , تونی , toni , тони , طوني , tony
تونی => توني , טוני , тоні , τόνι , تونى , toni , тони , طوني , tony
تيلور => تیلور , تایلور , تايلور
تیلور => تيلور , تایلور , تايلور
جؤاو => جواو , joão , joâo , joao , joäo , joáo , joāo
جاكسون => جاکسون , جکسون
جانسون => جونسون
جاکسون => جکسون , جاكسون
جوآن => ջոան , joan , جوان
جوئل => joël , جويل , ջոել , جویل , joel , йоел
جوان => ջոան , joan , جوآن
جواو => جؤاو , joão , joâo , joao , joäo , joáo , joāo
جورج => ժորժ , ζωρζ , žorž , жорж , ジョージ , ζορζ , ƶorƶ
جوزف => جوزيف
جوزيف => جوزف
جونسون => جانسون
جويل => joël , جوئل , ջոել , جویل , joel , йоел
جویل => joël , جويل , جوئل , ջոել , joel , йоел
جيان => jean
جيمس => جیمس , جەیمز , جیمز , יימס
جکسون => جاکسون , جاكسون
جیمز => جەیمز , جيمس , יימס
جیمس => جيمس , יימס
جەیمز => جیمز , جيمس
حرسي => ایان , حرصي , أيان , այան , هرسی , هرسي , ايان , حرصی , ayan , آیان , حرسی , آيان
حرسی => ایان , حرصي , أيان , այան , هرسی , هرسي , حرسي , ايان , حرصی , ayan , آیان , آيان
حرصي => ایان , أيان , այան , هرسی , هرسي , حرسي , ايان , حرصی , ayan , آیان , حرسی , آيان
حرصی => ایان , حرصي , أيان , այան , هرسی , هرسي , حرسي , ايان , ayan , آیان , حرسی , آيان
حييم => حییم , хаїм , haïm , хаім , haim , háim , חיים , хаим
حییم => хаїм , haïm , хаім , haim , háim , חיים , حييم , хаим
خوآن => хуан , huan , خوان , juan
خوان => хуан , huan , خوآن , juan
خوزه => jose , hosē , josé , josè , хосе , hose , خوسيه
خوسيه => خوزه
دايفيد => دیوید
دياز => دیاز , диаш , діас , diaz , diaš , díaz , діаз , діаш , диас , dias , диаз
ديرك => дырк , դիրկ , dirk , дирк , дірк , دیرک
ديفيد => دیفید , دیوید
ديفيس => دیویس , دیفیس
دیاز => диаш , діас , diaz , diaš , díaz , діаз , діаш , диас , دياز , dias , диаз
دیرک => дырк , դիրկ , dirk , ديرك , дирк , дірк
دیفید => ديفيد , دیوید
دیفیس => دیویس , ديفيس
دیوید => ديفيد , دايفيد , دیفید
دیویس => دیفیس , ديفيس
رائس => رايس , рајс , ռայս , rajs , rice , rays , رایس , райс
رابرت => روبەرت , روبرت
رابینسون => روبنسون
راسل => راسيل
راسيل => راسل
رايت => رایت , рајт , райт
رايس => рајс , ռայս , rajs , rice , rays , رایس , райс , رائس
رایت => رايت , рајт , райт
رایس => رايس , рајс , ռայս , rajs , rice , rays , райс , رائس
روبرت => رابرت , روبەرت
روبنسون => رابینسون
روبەرت => رابرت , روبرت
ريان => ライアン , ریان , ryan
ريتا => ریتا , ріта , ռիտա , рыта , рита , rita , ρίτα
ريتشارد => ریچارد
ريكي => рікі , ریکی , рики , ռիկի , riki , ρίκι
ریان => ライアン , ryan , ريان
ریتا => ріта , ريتا , ռիտա , рыта , рита , rita , ρίτα
ریچارد => ريتشارد
ریکی => рікі , рики , ريكي , ռիկի , riki , ρίκι
ساتو => satō , сато , sato , sató , satô
سارا => սարա , сара , sara , سارة , սառա , sára , σάρα
سارة => սարա , сара , sara , սառա , sára , سارا , σάρα
ساموئل => صموئيل
ستيف => ստիվ , стив , استيو , stiv , استیو , стів
ستيفن => استیون , ستیفن
ستيوارت => استوارت
ستیفن => ستيفن , استیون
سعيد => səid , saïd , սաիդ , said , саід , saíd , سعید , саїд , саид , سەید
سعید => səid , saïd , սաիդ , said , саід , saíd , سعيد , саїд , саид , سەید
سفين => свен , sven , սվեն
سكوت => سکوت , スコット , اسکات
سميت => смит , سمیت , сміт , smit , סמית
سميث => смит , сміт , سمیث , smit , סמית , اسمیت
سمیت => смит , сміт , سميت , smit , סמית
سمیث => смит , سميث , сміт , smit , اسمیت
سوفي => سوفی , софі , софӣ , софи , صوفي , սոֆի
سوفی => софі , софӣ , софи , صوفي , սոֆի , سوفي
سکوت => سكوت , スコット , اسکات
سەید => səid , saïd , սաիդ , said , саід , saíd , سعيد , سعید , саїд , саид
شارل => շառլ , шарл , შარლ , σαρλ , şarl , šarl , σάρλ
شميد => шмід , šmid , шмид
صموئيل => ساموئل
صوفي => سوفی , софі , софӣ , софи , սոֆի , سوفي
طومسون => تومسون , تامپسون
طوني => توني , טוני , تونى , тоні , τόνι , تونی , toni , тони , tony
عبدالعزيز => العزیز , عبدالعزیز , العزيز
عبدالعزیز => العزیز , العزيز , عبدالعزيز
عبدالله => الله
عزيز => азіз , ազիզ , азиз , azíz , aziz , عزیز
عزیز => азіз , ազիզ , азиз , عزيز , azíz , aziz
غاري => gari , гари , гары , գարի , gary , гарі
غراي => grây , gray
غريغ => грег , грэг , greg , գրեգ
غرين => грін , գրին , ґрін , грин
غوردون => گوردون
فاکس => فوكس
فورد => форд , ford , ֆորդ
فوكس => фокс , فاکس , فوکس , foks
فوکس => фокс , foks , فوكس
فيرا => вера , věra , վերա , فیرا , vera
فيكتور => فیکتور , ویکتور
فيليب => فیلیپ
فیرا => فيرا , вера , věra , վերա , vera
فیلیپ => فيليب
فیکتور => فيكتور , ویکتور
قاعدة => لاعب
كاتو => kató , کاتو , kato , като , katō
كارل => отто , オットー , karl , carl , կարլ , карл , קארל , կառլ , კარლ , καρλ , otto , کارل
كارى => кэри , кери , кері , كاري , keri
كاري => кэри , كارى , кери , кері , keri
كايل => kyle , کایل , կայլ
كريس => крис , kris , کریس , крыс , כריס , кріс , κρις
كلود => klod , клод , կլոդ , کلود
كوجي => کوجی , կոջի , kōji , koji , kôji
كورت => курт , kurt , کورت
كولينز => کالینز
كوهن => κοέν , koen , κόεν , کوهن , коен , коэн
كيرك => кирк , кірк , kirk , կիրկ
كيفن => کوین
كينت => کینت , кент , kent
كينغ => кинг , کینگ , кінг , king
لئون => león , լեոն , لیون , леон , léon , λεόν , leon , ليون , λέων , λέον
لاعب => john , قاعدة
لانغ => ланг , lang , լանգ , láng
لوئیس => لویس , لويس
لوري => lori , лори , лорі , λόρι , לורי , لوری
لوری => lori , лори , لوري , лорі , λόρι , לורי
لوكا => lwka , luka , люка , lūka , لوکا , лука
لويس => луíс , луїш , luiş , لویس , луис , luís , луїс , луіс , لوئیس , luis , луіш , lüis , луиш , люис
لوکا => lwka , luka , люка , лука , lūka , لوكا
لویس => луíс , луїш , luiş , луис , لويس , luís , луїс , луіс , لوئیس , luis , луіш , lüis , луиш , люис
ليام => ліям , лиам , լիամ , ліам , liam , لیام , λίαμ
ليزا => лиса , liza , lisa , ліза , լիզա , лиза , λίζα , līsa , līza , لیزا
ليما => лима , լիմա , لیما , ліма , lima
ليون => león , լեոն , لیون , леон , λεόν , leon , لئون , léon , λέων , λέον
لیام => ліям , лиам , լիամ , ліам , liam , ليام , λίαμ
لیزا => лиса , liza , lisa , ліза , լիզա , ليزا , лиза , λίζα , līsa , līza
لیما => лима , լիմա , ліма , lima , ليما
لیون => león , լեոն , леон , léon , λεόν , leon , لئون , ليون , λέων , λέον
مارتن => مارتين , مارتین
مارتين => مارتن , مارتین
مارتین => مارتين , مارتن
مارك => מארק , marc , մարկ , μαρκ , მარკ , mark , марк , مارک , μάρκ
مارى => մարի , мері , ماری , meri , мэри , mari , mary , мери , марі , μαρί , мари , μέρι , մերի , мары , ماري
ماري => մարի , ماری , meri , мэри , mari , მერი , մերի , mary , мери , марі , μαρί , メアリー , мари , μέρι , мері , мары , مارى
مارک => מארק , marc , մարկ , مارك , μαρκ , მარკ , mark , марк , μάρκ
ماری => մարի , мері , meri , мэри , mari , mary , мери , марі , ماري , μαρί , メアリー , мари , μέρι , մերի , мары , مارى
ماكس => マックス , maks , ماکس , მაქს , макс
مايك => mike , mayk , մայկ , міке , majk , مایک , мике , майк , мајк
مايكل => ميخائيل , میخائیل , مایکل
ماکس => マックス , ماكس , maks , მაქს , макс
مایک => mike , mayk , مايك , մայկ , міке , majk , мике , майк , мајк
مایکل => مايكل , ميخائيل , میخائیل
محمد => 穆罕默德 , מחמד
موري => mōri , موری , морі , mori , մորի , мори , מורי
موری => موري , mōri , морі , mori , մորի , мори , מורי
موسى => musa , mūsā , موسی , муса , موسي
موسي => musa , mūsā , موسی , муса , موسى
موسی => musa , mūsā , муса , موسي , موسى
ميخائيل => مايكل , میخائیل , مایکل
ميكي => μίκι , miki , միկի , мікі , میکی , мики
میخائیل => مايكل , ميخائيل , مایکل
میکی => μίκι , miki , միկի , мікі , мики , ميكي
نوئل => νοέλ , noel , نويل , noèl , նոել , ноел , ноэл , νόελ , noël , nöel
نويل => νοέλ , noel , noèl , նոել , ноел , ноэл , νόελ , نوئل , noël , nöel
نينا => нина , նինա , ніна , nīnà , نینا , nina
نينو => نینو , נינו , ніно , նինո , nino , νίνο , нино , niño
نینا => نينا , нина , նինա , ніна , nīnà , nina
نینو => نينو , נינו , ніно , նինո , nino , νίνο , нино , niño
هاريس => هریس
هانت => հանտ , hunt , хант
هانز => հանս , ханс , hans
هانس => ჰანს , hans , հանս , ханс , gans , χανς , ганс
هاوارد => هوارد
هرسي => ایان , حرصي , أيان , այան , هرسی , حرسي , ايان , حرصی , ayan , آیان , حرسی , آيان
هرسی => ایان , حرصي , أيان , այան , هرسي , حرسي , ايان , حرصی , ayan , آیان , حرسی , آيان
هریس => هاريس
هنرى => ανρί , анрі , анри , ヘンリー , هنري , هنری , anri , անրի , הנרי , anrī
هنري => anrī , ανρί , анрі , анри , ヘンリー , هنری , anri , անրի , הנרי , هنرى
هنری => anrī , ανρί , анрі , анри , ヘンリー , هنري , anri , անրի , הנרי , هنرى
هوارد => هاوارد
هورن => הורן , հորն , horn , хорн
هوغو => хюго , hugo , хуго
هولت => холт , holt
وارد => ward , ウォード
وايت => ўайт , ホワイト , уайт , وایت
واکر => ووكر
وایت => وايت , ўайт , ホワイト , уайт
وليام => ویلیام , ويليام , ولیام
وليامز => ویلیامز , ويليامز , ولیامز
ولیام => وليام , ویلیام , ويليام
ولیامز => وليامز , ویلیامز , ويليامز
ووكر => واکر
وولف => wolf
ويليام => وليام , ویلیام , ولیام
ويليامز => وليامز , ویلیامز , ولیامز
ویلیام => وليام , ويليام , ولیام
ویلیامز => وليامز , ويليامز , ولیامز
ویکتور => فيكتور , فیکتور
يوري => yuri , יורי , юрий , یوری , юрій , juri , јури
يوكي => yuki , یوکی , yûki , yūki
يونغ => یانگ
پاتریک => باتريك
پاشا => паша , pasha , paša , պաշա , pașa , pasa , ფაშა , paşa
پيتر => פיטר , پیتەر , بیتر , بيتر , ピーター , پیتر , پیتێر
پیئر => пиер , πιερ , πιέρ , پییر , պիեռ , פייר
پیتر => פיטר , پيتر , پیتەر , بیتر , بيتر , ピーター , پیتێر
پیتێر => پيتر , پیتەر , بیتر , بيتر , پیتر
پیتەر => پيتر , بیتر , بيتر , پیتر , پیتێر
پییر => пиер , پیئر , πιερ , πιέρ , պիեռ , פייר
چارلز => تشارلز
کاتو => kató , kato , като , katō , كاتو
کارل => отто , كارل , オットー , karl , carl , կարլ , карл , קארל , կառլ , კარლ , καρλ , otto
کالینز => كولينز
کایل => كايل , kyle , կայլ
کریس => крис , kris , крыс , כריס , كريس , кріс , κρις
کلود => klod , կլոդ , клод , كلود
کوجی => կոջի , kōji , koji , كوجي , kôji
کورت => курт , kurt , كورت
کوهن => κοέν , koen , κόεν , коен , كوهن , коэн
کوین => كيفن
کینت => كينت , кент , kent
کینگ => кинг , كينغ , кінг , king
گرین => грын , грін , грин , גרין , գրին , ґрін
گوردون => غوردون
یانگ => يونغ
یوری => yuri , יורי , юрий , يوري , юрій , juri , јури
یوکی => yuki , yûki , yūki , يوكي
ܕܘܢܤ => ᕤᐒᓄᔅ , ლილა , lila , ліля , ліла , ዶወንሡ , ዾውንስ , ܠܝܠܐ , լիլա , λίλα , ዳውንስ , лила
ܠܝܠܐ => ᕤᐒᓄᔅ , ლილა , ܕܘܢܤ , lila , ліля , ліла , ዶወንሡ , ዾውንስ , լիլա , λίλα , ዳውንስ , лила
अहमद => ଅହମଦ , ਅਹਮਦ , అహమద , ಅಹಮದ , അഹമദ , أحمد , আহমদ , અહમદ , احمد
আহমদ => अहमद , ଅହମଦ , ਅਹਮਦ , అహమద , അഹമദ , ಅಹಮದ , أحمد , અહમદ , احمد
ਅਹਮਦ => अहमद , ଅହମଦ , അഹമദ , అహమద , ಅಹಮದ , أحمد , আহমদ , અહમદ , احمد
અહમદ => अहमद , ଅହମଦ , ਅਹਮਦ , అహమద , അഹമദ , ಅಹಮದ , أحمد , আহমদ , احمد
ଅହମଦ => अहमद , ਅਹਮਦ , ಅಹಮದ , అహమద , അഹമദ , أحمد , আহমদ , અહમદ , احمد
అహమద => अहमद , ଅହମଦ , ਅਹਮਦ , ಅಹಮದ , അഹമദ , أحمد , আহমদ , અહમદ , احمد
ಅಹಮದ => अहमद , ଅହମଦ , ਅਹਮਦ , అహమద , അഹമദ , أحمد , আহমদ , અહમદ , احمد
അഹമദ => अहमद , ଅହମଦ , ਅਹਮਦ , ಅಹಮದ , అహమద , أحمد , আহমদ , અહમદ , احمد
สมเด => pave , papa , fòng , pápa , pāpa , hông , pópù , pous , giáo , pope , paus , pàpa , папа
โฮเซ => jose , josé , хосе , josè
ბრუს => brus , брюс , brüs , ブルース , брус
გარი => гари , гары , գարի , gary , гарі
გერი => гэри , гері , ґері , гери , գերի , ゲーリー , gary
დიას => դիաս , dïas , diáz , диаз , diaz , díaz , діаз , диас , діас
ემილ => эмил , エミール , エーミル , εμίλ , emil , έμιλ , էմիլ , емил
იგორ => игор , イゴーリ , ígor , իգոր , igor , イーゴリ , ігор
ივან => ívan , îvan , iван , иван , i̇van , イヴァン , ивaн , iwan , ïvan , ivan , iván , իվան , іван , ιβάν , îwan
კარლ => كارل , karl , կարլ , карл , կառլ , καρλ , کارل
ლიზა => лиса , liza , lisa , ліза , լիզա , лиза , λίζα , līsa , līza
ლილა => ᕤᐒᓄᔅ , ܕܘܢܤ , lila , ліля , ліла , ዶወንሡ , ዾውንስ , ܠܝܠܐ , լիլա , λίλα , ዳውንስ , лила
მარკ => μάρκ , مارك , mark , марк , مارک , մարկ
მაქს => マックス , ماكس , maks , ماکس , макс
მერი => meri , мэри , մերի , mary , мери , メアリー , μέρι , мері , ماري
როუზ => rouz , роўз , rose , роуз , rosé , росе
სთივ => ստիվ , стив , stiv , սթիվ , სტივ , стів
სტივ => სთივ , ստիվ , стив , stiv , սթիվ , стів
უმარ => ʿumar , ömər , omar , umar , ӏумар , omár , ομάρ , ʿomar , úmar , умар , омар
ფაშა => پاشا , паша , pasha , paša , պաշա , pașa , pasa , paşa
შარლ => շառլ , шарл , σαρλ , şarl , šarl , σάρλ , شارل
ჯორჯ => ջորջ , jorj , ジョージ
ჰანს => هانس , hans , հանս , ханс , gans , χανς , ганс
ዳውንስ => ᕤᐒᓄᔅ , ლილა , ܕܘܢܤ , lila , ліля , ліла , ዶወንሡ , ዾውንስ , ܠܝܠܐ , լիլա , λίλα , лила
ዶወንሡ => ᕤᐒᓄᔅ , ლილა , ܕܘܢܤ , lila , ліля , ліла , ዾውንስ , ܠܝܠܐ , լիլա , λίλα , ዳውንስ , лила
ዾውንስ => ᕤᐒᓄᔅ , ლილა , ܕܘܢܤ , lila , ліля , ліла , ዶወንሡ , ܠܝܠܐ , լիլա , λίλα , ዳውንስ , лила
ᕤᐒᓄᔅ => ლილა , ܕܘܢܤ , lila , ліля , ліла , ዶወንሡ , ዾውንስ , ܠܝܠܐ , լիլա , λίλα , ዳውንስ , лила
アンディ => andy , أندي , անդի , анди , анді , اندی
アーサー => أرثر , آرثر , ارثر
イゴーリ => იგორ , игор , ígor , իգոր , igor , イーゴリ , ігор
イヴァン => ívan , îvan , iван , иван , іван , ивaн , ივან , ïvan , iván , իվան , ivan
イーゴリ => იგორ , игор , イゴーリ , ígor , իգոր , igor , ігор
ウォード => وارد , ward
エミール => اميل , эмил , أميل , エーミル , إميل , ემილ , εμίλ , امیل , emil , έμιλ , էմիլ , емил
エリック => erik , اريك , ерик , eric , έρικ , эрик , ερίκ , اریک , éric , أريك , ерік , էրիկ , إريك
エーミル => اميل , эмил , أميل , エミール , إميل , ემილ , εμίλ , امیل , emil , έμιλ , էմիլ , емил
オットー => отто , كارل , karl , карл , καρλ , otto , کارل
クロード => կլոդ , klod , клод
グレッグ => грег , грэг , greg , գրեգ
ゲイリー => gary , гары
ゲーリー => гэри , гері , ґері , гери , գերի , გერი , gary
シャルル => շառլ , шарл , շարլ , σαρλ , şarl , šarl , σάρλ
ジェイムズ => ジェームズ
ジェームズ => ジェイムズ
ジャック => džek , джек , jack , джэк
ジュアン => jose , juan , josé , josè , joan
ジョアオ => joão , joâo , ジョアン , joao , joäo , йоан , joáo , joāo
ジョアン => joão , joâo , joāo , joao , jean , joäo , ジョアオ , йоан , joáo , joan
ジョージ => ջորջ , jorj , جورج , ჯორჯ
スコット => سكوت , سکوت
ピエール => пиер , πιερ , pier , πιέρ , пьер , պիեռ , պիեր
ピーター => פיטר , پيتر , بیتر , بيتر , پیتر
フランク => פרנק
フレッド => фрэд , ֆրեդ , фред , fred
ブルース => brus , بروس , ბრუს , брюс , brüs , ברוס , брус
ヘンリー => هنري , הנרי , هنرى , هنری
ホワイト => وايت , وایت
マックス => ماكس , maks , ماکس , მაქს , макс
マリーア => maría , maria , марія , anna , mária , анна , μαρία , άννα , мария
メアリー => мері , meri , ماری , мэри , მერი , mary , мери , μέρι , մերի , ماري
ユーリー => yuri , juri , јури
ライアン => ریان , ryan , ريان
亚力克斯 => 亞力克斯 , alex , àlex , 亞歴克斯 , 亚历克斯 , άλεξ , 亞歷克斯 , álex
亚历克斯 => 亞力克斯 , alex , àlex , 亞歴克斯 , 亚力克斯 , άλεξ , 亞歷克斯 , álex
亞力克斯 => alex , àlex , 亞歴克斯 , 亚历克斯 , 亚力克斯 , άλεξ , 亞歷克斯 , álex
亞歴克斯 => 亞力克斯 , alex , àlex , 亚历克斯 , 亚力克斯 , άλεξ , 亞歷克斯 , álex
亞歷克斯 => 亞力克斯 , alex , àlex , 亞歴克斯 , 亚历克斯 , 亚力克斯 , άλεξ , álex
穆罕默德 => מחמד , محمد
艾哈迈德 => 艾哈邁德 , 艾哈麥德 , أحمد , احمد
艾哈邁德 => أحمد , 艾哈麥德 , احمد , 艾哈迈德
艾哈麥德 => 艾哈邁德 , أحمد , احمد , 艾哈迈德
